Trans. Date,Reference,Value. Date,Debits,Credits,Balance,Remarks_processed,ACCOUNT_TYPE,BANK_ID,FILE_NAME,filtered_description,processed_description,CLASSE
07-Dec-2020,'0GAPS,07-Dec-2020,,"308,750.00","278,851.80",TRANSFER BETWEEN CUSTOMERS via GAPScom on Babawuro A 13M sales 104164162 0 fromNETCONSTRUCT NIGERIA LIMITED to ASHAFAIBRAHIM ABDULLAHIREF: 0005628626104164162000000,SAVINGS ACCOUNT,GT_Bank,./static/raw/MR_IBRAHIM_ASHAFA_STATEMENT.pdf,TRANSFER BETWEEN CUSTOMERS via GAPScom on Babawuro A M sales fromNETCONSTRUCT NIGERIA LIMITED to ASHAFAIBRAHIM ABDULLAHIREF,TRANSFER BETWEEN CUSTOMERS via GAPScom on BabawuroM sales from NETCONSTRUCT NIGERIA LIMITED to ASHAFAIBRAHIM ABDULLAHIREF,transfert
07-Dec-2020,'0GAPS,07-Dec-2020,,"82,092.39","360,944.19",TRANSFER BETWEEN CUSTOMERS via GAPScom on Ekene Nnabuhie 3M sales 104164068 0 fromNETCONSTRUCT NIGERIA LIMITED to ASHAFAIBRAHIM ABDULLAHIREF: 0005628626104164068000000,SAVINGS ACCOUNT,GT_Bank,./static/raw/MR_IBRAHIM_ASHAFA_STATEMENT.pdf,TRANSFER BETWEEN CUSTOMERS via GAPScom on Ekene Nnabuhie M sales fromNETCONSTRUCT NIGERIA LIMITED to ASHAFAIBRAHIM ABDULLAHIREF,TRANSFER BETWEEN CUSTOMERS via GAPScom on Ekene Nnabuhiesales from NETCONSTRUCT NIGERIA LIMITED to ASHAFAIBRAHIM ABDULLAHIREF,transfert
07-Dec-2020,'0GWTR,07-Dec-2020.1,"50,000.00",,"310,944.19","TRANSFER BETWEEN CUSTOMERS Via GTWorld Eneke   REF:681976569000000500002012070913 from ASHAFA IBRAHIM ABDULLAHI  to  SALAMI, ABUBAKAR",SAVINGS ACCOUNT,GT_Bank,./static/raw/MR_IBRAHIM_ASHAFA_STATEMENT.pdf,TRANSFER BETWEEN CUSTOMERS Via GTWorld Eneke REF from ASHAFA IBRAHIM ABDULLAHI to SALAMI ABUBAKAR,TRANSFER BETWEEN CUSTOMERS Via GTWorld Eneke REF from ASHAFA IBRAHIM ABDULLAHI to SALAMI ABUBAKAR,transfert
07-Dec-2020,'0NIPG,07-Dec-2020,"140,000.00",,"170,944.19",NIBSS Instant Payment Outward 000013201207091758000279938909 via GTWORLD Babawuro Ali TO FBN/MANCHA GILBERT SIMI /53.75/REF:GW6819765690000014000020120709  f,SAVINGS ACCOUNT,GT_Bank,./static/raw/MR_IBRAHIM_ASHAFA_STATEMENT.pdf,NIBSS Instant Payment Outward via GTWORLD Babawuro Ali TO FBN MANCHA GILBERT SIMI REF GW f,NIBSS Instant Payment Outward via GTWORLD Babawuro Ali TO FBN MANCHA GILBERT SIMI REF GW,transfert
07-Dec-2020,'0NIPG,07-Dec-2020,50.00,,"170,894.19",COMMISSION 000013201207091758000279938909 NIP TRANSFER COMMISSION FOR 000013201207091758000279938909 via GTWORLD Babawuro Ali TO FBN/MANCHA GILBERT SIMI ReF:GW681976569000001400002012070916,SAVINGS ACCOUNT,GT_Bank,./static/raw/MR_IBRAHIM_ASHAFA_STATEMENT.pdf,COMMISSION NIP TRANSFER COMMISSION FOR via GTWORLD Babawuro Ali TO FBN MANCHA GILBERT SIMI ReF GW,COMMISSION NIP TRANSFER COMMISSION FOR via GTWORLD Babawuro Ali TO FBN MANCHA GILBERT SIMI ReF GW,commission
07-Dec-2020,'0NIPG,07-Dec-2020,3.75,,"170,890.44",VALUE ADDED TAX 000013201207091758000279938909 VAT ON NIP TRANSFER FOR 000013201207091758000279938909 via GTWORLD Babawuro Ali TO FBN/MANCHA GILBERT SIMI ReF:GW681976569000001400002012070916,SAVINGS ACCOUNT,GT_Bank,./static/raw/MR_IBRAHIM_ASHAFA_STATEMENT.pdf,VALUE ADDED TAX VAT ON NIP TRANSFER FOR via GTWORLD Babawuro Ali TO FBN MANCHA GILBERT SIMI ReF GW,VALUE ADDED TAX VAT ON NIP TRANSFER FOR via GTWORLD Babawuro Ali TO FBN MANCHA GILBERT SIMI ReF GW,tax
07-Dec-2020,'0NIPG,07-Dec-2020,"50,000.00",,"120,890.44",NIBSS Instant Payment Outward 000013201207093509000279967650 via GTWORLD  TO ACCESS/KEREN RIKKO /26.875/REF:GW6819765690000005000020120709 f,SAVINGS ACCOUNT,GT_Bank,./static/raw/MR_IBRAHIM_ASHAFA_STATEMENT.pdf,NIBSS Instant Payment Outward via GTWORLD TO ACCESS KEREN RIKKO REF GW f,NIBSS Instant Payment Outward via GTWORLD TO ACCESS KEREN RIKKO REF GW,transfert
07-Dec-2020,'0NIPG,07-Dec-2020,25.00,,"120,865.44",COMMISSION 000013201207093509000279967650 NIP TRANSFER COMMISSION FOR 000013201207093509000279967650 via GTWORLD  TO ACCESS/KEREN RIKKO ReF:GW681976569000000500002012070934,SAVINGS ACCOUNT,GT_Bank,./static/raw/MR_IBRAHIM_ASHAFA_STATEMENT.pdf,COMMISSION NIP TRANSFER COMMISSION FOR via GTWORLD TO ACCESS KEREN RIKKO ReF GW,COMMISSION NIP TRANSFER COMMISSION FOR via GTWORLD TO ACCESS KEREN RIKKO ReF GW,commission
07-Dec-2020,'0NIPG,07-Dec-2020,1.87,,"120,863.57",VALUE ADDED TAX 000013201207093509000279967650 VAT ON NIP TRANSFER FOR 000013201207093509000279967650 via GTWORLD  TO ACCESS/KEREN RIKKO ReF:GW681976569000000500002012070934,SAVINGS ACCOUNT,GT_Bank,./static/raw/MR_IBRAHIM_ASHAFA_STATEMENT.pdf,VALUE ADDED TAX VAT ON NIP TRANSFER FOR via GTWORLD TO ACCESS KEREN RIKKO ReF GW,VALUE ADDED TAX VAT ON NIP TRANSFER FOR via GTWORLD TO ACCESS KEREN RIKKO ReF GW,tax
07-Dec-2020,'0NIPG,07-Dec-2020.1,"15,000.00",,"105,863.57",NIBSS Instant Payment Outward 000013201207093604000279969267 via GTWORLD  TO UBA/YAKUBU ASHAFA ABDULLAHI /26.875/REF:GW6819765690000001500020120709 f,SAVINGS ACCOUNT,GT_Bank,./static/raw/MR_IBRAHIM_ASHAFA_STATEMENT.pdf,NIBSS Instant Payment Outward via GTWORLD TO UBA YAKUBU ASHAFA ABDULLAHI REF GW f,NIBSS Instant Payment Outward via GTWORLD TO UBA YAKUBU ASHAFA ABDULLAHI REF GW,transfert
07-Dec-2020,'0NIPG,07-Dec-2020,25.00,,"105,838.57",COMMISSION 000013201207093604000279969267 NIP TRANSFER COMMISSION FOR 000013201207093604000279969267 via GTWORLD  TO UBA/YAKUBU ASHAFA ABDULLAHI ReF:GW681976569000000150002012070935,SAVINGS ACCOUNT,GT_Bank,./static/raw/MR_IBRAHIM_ASHAFA_STATEMENT.pdf,COMMISSION NIP TRANSFER COMMISSION FOR via GTWORLD TO UBA YAKUBU ASHAFA ABDULLAHI ReF GW,COMMISSION NIP TRANSFER COMMISSION FOR via GTWORLD TO UBA YAKUBU ASHAFA ABDULLAHI ReF GW,commission
07-Dec-2020,'0NIPG,07-Dec-2020,1.87,,"105,836.70",VALUE ADDED TAX 000013201207093604000279969267 VAT ON NIP TRANSFER FOR 000013201207093604000279969267 via GTWORLD  TO UBA/YAKUBU ASHAFA ABDULLAHI ReF:GW681976569000000150002012070935,SAVINGS ACCOUNT,GT_Bank,./static/raw/MR_IBRAHIM_ASHAFA_STATEMENT.pdf,VALUE ADDED TAX VAT ON NIP TRANSFER FOR via GTWORLD TO UBA YAKUBU ASHAFA ABDULLAHI ReF GW,VALUE ADDED TAX VAT ON NIP TRANSFER FOR via GTWORLD TO UBA YAKUBU ASHAFA ABDULLAHI ReF GW,tax
07-Dec-2020,'0NIPG,07-Dec-2020,"3,000.00",,"102,836.70",NIBSS Instant Payment Outward 000013201207093810000279973074 via GTWORLD  TO UBA/GAMBO I YUSUF /10.75/REF:GW6819765690000000300020120709  f,SAVINGS ACCOUNT,GT_Bank,./static/raw/MR_IBRAHIM_ASHAFA_STATEMENT.pdf,NIBSS Instant Payment Outward via GTWORLD TO UBA GAMBO I YUSUF REF GW f,NIBSS Instant Payment Outward via GTWORLD TO UBA GAMBOYUSUF REF GW,transfert
07-Dec-2020,'0NIPG,07-Dec-2020,10.00,,"102,826.70",COMMISSION 000013201207093810000279973074 NIP TRANSFER COMMISSION FOR 000013201207093810000279973074 via GTWORLD  TO UBA/GAMBO I YUSUF ReF:GW681976569000000030002012070937,SAVINGS ACCOUNT,GT_Bank,./static/raw/MR_IBRAHIM_ASHAFA_STATEMENT.pdf,COMMISSION NIP TRANSFER COMMISSION FOR via GTWORLD TO UBA GAMBO I YUSUF ReF GW,COMMISSION NIP TRANSFER COMMISSION FOR via GTWORLD TO UBA GAMBOYUSUF ReF GW,commission
07-Dec-2020,'0NIPG,07-Dec-2020,.75,,"102,825.95",VALUE ADDED TAX 000013201207093810000279973074 VAT ON NIP TRANSFER FOR 000013201207093810000279973074 via GTWORLD  TO UBA/GAMBO I YUSUF ReF:GW681976569000000030002012070937,SAVINGS ACCOUNT,GT_Bank,./static/raw/MR_IBRAHIM_ASHAFA_STATEMENT.pdf,VALUE ADDED TAX VAT ON NIP TRANSFER FOR via GTWORLD TO UBA GAMBO I YUSUF ReF GW,VALUE ADDED TAX VAT ON NIP TRANSFER FOR via GTWORLD TO UBA GAMBOYUSUF ReF GW,tax
07-Dec-2020,'0NIPG,07-Dec-2020,"4,000.00",,"98,825.95",NIBSS Instant Payment Outward 000013201207094005000279976405 via GTWORLD  TO ECO/HASSAN ABDULLAHI /10.75/REF:GW6819765690000000400020120709  f,SAVINGS ACCOUNT,GT_Bank,./static/raw/MR_IBRAHIM_ASHAFA_STATEMENT.pdf,NIBSS Instant Payment Outward via GTWORLD TO ECO HASSAN ABDULLAHI REF GW f,NIBSS Instant Payment Outward via GTWORLD TO ECO HASSAN ABDULLAHI REF GW,transfert
07-Dec-2020,'0NIPG,07-Dec-2020,10.00,,"98,815.95",COMMISSION 000013201207094005000279976405NIP TRANSFER COMMISSION FOR 000013201207094005000279976405 via GTWORLD  TO ECO/HASSAN ABDULLAHI ReF:GW681976569000000040002012070939,SAVINGS ACCOUNT,GT_Bank,./static/raw/MR_IBRAHIM_ASHAFA_STATEMENT.pdf,COMMISSION NIP TRANSFER COMMISSION FOR via GTWORLD TO ECO HASSAN ABDULLAHI ReF GW,COMMISSION NIP TRANSFER COMMISSION FOR via GTWORLD TO ECO HASSAN ABDULLAHI ReF GW,commission
07-Dec-2020,'0NIPG,07-Dec-2020,.75,,"98,815.20",VALUE ADDED TAX 000013201207094005000279976405 VAT ON NIP TRANSFER FOR 000013201207094005000279976405 via GTWORLD  TO ECO/HASSAN ABDULLAHI ReF:GW681976569000000040002012070939,SAVINGS ACCOUNT,GT_Bank,./static/raw/MR_IBRAHIM_ASHAFA_STATEMENT.pdf,VALUE ADDED TAX VAT ON NIP TRANSFER FOR via GTWORLD TO ECO HASSAN ABDULLAHI ReF GW,VALUE ADDED TAX VAT ON NIP TRANSFER FOR via GTWORLD TO ECO HASSAN ABDULLAHI ReF GW,tax
07-Dec-2020,'0NIPG,07-Dec-2020,"20,000.00",,"78,815.20",NIBSS Instant Payment Outward 000013201207094036000279977352 via GTWORLD  TO UBA/ALIYU HAUWA /26.875/REF:GW6819765690000002000020120709 f,SAVINGS ACCOUNT,GT_Bank,./static/raw/MR_IBRAHIM_ASHAFA_STATEMENT.pdf,NIBSS Instant Payment Outward via GTWORLD TO UBA ALIYU HAUWA REF GW f,NIBSS Instant Payment Outward via GTWORLD TO UBA ALIYU HAUWA REF GW,transfert
07-Dec-2020,'0NIPG,07-Dec-2020,25.00,,"78,790.20",COMMISSION 000013201207094036000279977352 NIP TRANSFER COMMISSION FOR 000013201207094036000279977352 via GTWORLD  TO UBA/ALIYU HAUWA ReF:GW681976569000000200002012070939,SAVINGS ACCOUNT,GT_Bank,./static/raw/MR_IBRAHIM_ASHAFA_STATEMENT.pdf,COMMISSION NIP TRANSFER COMMISSION FOR via GTWORLD TO UBA ALIYU HAUWA ReF GW,COMMISSION NIP TRANSFER COMMISSION FOR via GTWORLD TO UBA ALIYU HAUWA ReF GW,commission
07-Dec-2020,'0NIPG,07-Dec-2020,1.87,,"78,788.33",VALUE ADDED TAX 000013201207094036000279977352 VAT ON NIP TRANSFER FOR 000013201207094036000279977352 via GTWORLD  TO UBA/ALIYU HAUWA ReF:GW681976569000000200002012070939,SAVINGS ACCOUNT,GT_Bank,./static/raw/MR_IBRAHIM_ASHAFA_STATEMENT.pdf,VALUE ADDED TAX VAT ON NIP TRANSFER FOR via GTWORLD TO UBA ALIYU HAUWA ReF GW,VALUE ADDED TAX VAT ON NIP TRANSFER FOR via GTWORLD TO UBA ALIYU HAUWA ReF GW,tax
07-Dec-2020,'0NIPG,07-Dec-2020,"20,000.00",,"58,788.33",NIBSS Instant Payment Outward 000013201207095014000279994062 via GTWORLD  TO UBA/YUSUF HASSAN /26.875/REF:GW6819765690000002000020120709 f,SAVINGS ACCOUNT,GT_Bank,./static/raw/MR_IBRAHIM_ASHAFA_STATEMENT.pdf,NIBSS Instant Payment Outward via GTWORLD TO UBA YUSUF HASSAN REF GW f,NIBSS Instant Payment Outward via GTWORLD TO UBA YUSUF HASSAN REF GW,transfert
07-Dec-2020,'0NIPG,07-Dec-2020,25.00,,"58,763.33",COMMISSION 000013201207095014000279994062 NIP TRANSFER COMMISSION FOR 000013201207095014000279994062 via GTWORLD  TO UBA/YUSUF HASSAN ReF:GW681976569000000200002012070949,SAVINGS ACCOUNT,GT_Bank,./static/raw/MR_IBRAHIM_ASHAFA_STATEMENT.pdf,COMMISSION NIP TRANSFER COMMISSION FOR via GTWORLD TO UBA YUSUF HASSAN ReF GW,COMMISSION NIP TRANSFER COMMISSION FOR via GTWORLD TO UBA YUSUF HASSAN ReF GW,commission
07-Dec-2020,'0NIPG,07-Dec-2020,1.87,,"58,761.46",VALUE ADDED TAX 000013201207095014000279994062 VAT ON NIP TRANSFER FOR000013201207095014000279994062 viaGTWORLD  TO UBA/YUSUF HASSANReF:GW681976569000000200002012070949,SAVINGS ACCOUNT,GT_Bank,./static/raw/MR_IBRAHIM_ASHAFA_STATEMENT.pdf,VALUE ADDED TAX VAT ON NIP TRANSFER FOR viaGTWORLD TO UBA YUSUF HASSANReF GW,VALUE ADDED TAX VAT ON NIP TRANSFER FOR via GTWORLD TO UBA YUSUF HASSANReF GW,tax
07-Dec-2020,'0NIPG,07-Dec-2020,"2,000.00",,"56,761.46","NIBSS Instant Payment Outward000013201207095253000279998609 viaGTWORLD  TO UBA/ABUBAKAR, ABDULQADISADIQ/10.75/REF:GW6819765690000000200020120709  f",SAVINGS ACCOUNT,GT_Bank,./static/raw/MR_IBRAHIM_ASHAFA_STATEMENT.pdf,NIBSS Instant Payment Outward viaGTWORLD TO UBA ABUBAKAR ABDULQADISADIQ REF GW f,NIBSS Instant Payment Outward via GTWORLD TO UBA ABUBAKAR ABDULQADISADIQ REF GW,transfert
07-Dec-2020,'0NIPG,07-Dec-2020,10.00,,"56,751.46","COMMISSION 000013201207095253000279998609NIP TRANSFER COMMISSION FOR000013201207095253000279998609 viaGTWORLD  TO UBA/ABUBAKAR, ABDULQADISADIQReF:GW681976569000000020002012070951",SAVINGS ACCOUNT,GT_Bank,./static/raw/MR_IBRAHIM_ASHAFA_STATEMENT.pdf,COMMISSION NIP TRANSFER COMMISSION FOR viaGTWORLD TO UBA ABUBAKAR ABDULQADISADIQReF GW,COMMISSION NIP TRANSFER COMMISSION FOR via GTWORLD TO UBA ABUBAKAR ABDULQADISADIQReF GW,commission
07-Dec-2020,'0NIPG,07-Dec-2020,.75,,"56,750.71","VALUE ADDED TAX000013201207095253000279998609 VAT ON NIPTRANSFER FOR000013201207095253000279998609 viaGTWORLD  TO UBA/ABUBAKAR, ABDULQADISADIQReF:GW681976569000000020002012070951",SAVINGS ACCOUNT,GT_Bank,./static/raw/MR_IBRAHIM_ASHAFA_STATEMENT.pdf,VALUE ADDED TAX VAT ON NIPTRANSFER FOR viaGTWORLD TO UBA ABUBAKAR ABDULQADISADIQReF GW,VALUE ADDED TAX VAT ON NIPTRANSFER FOR via GTWORLD TO UBA ABUBAKAR ABDULQADISADIQReF GW,tax
07-Dec-2020,'0NIPG,07-Dec-2020,"5,000.00",,"51,750.71",NIBSS Instant Payment Outward000013201207101800000280044205 viaGTWORLD  TO ACCESS/HAPPY EKKI YAKUBU/10.75/REF:GW6819765690000000500020120710  f,SAVINGS ACCOUNT,GT_Bank,./static/raw/MR_IBRAHIM_ASHAFA_STATEMENT.pdf,NIBSS Instant Payment Outward viaGTWORLD TO ACCESS HAPPY EKKI YAKUBU REF GW f,NIBSS Instant Payment Outward via GTWORLD TO ACCESS HAPPY EKKI YAKUBU REF GW,transfert
07-Dec-2020,'0NIPG,07-Dec-2020,10.00,,"51,740.71",COMMISSION 000013201207101800000280044205NIP TRANSFER COMMISSION FOR000013201207101800000280044205 viaGTWORLD  TO ACCESS/HAPPY EKKI YAKUBUReF:GW681976569000000050002012071016,SAVINGS ACCOUNT,GT_Bank,./static/raw/MR_IBRAHIM_ASHAFA_STATEMENT.pdf,COMMISSION NIP TRANSFER COMMISSION FOR viaGTWORLD TO ACCESS HAPPY EKKI YAKUBUReF GW,COMMISSION NIP TRANSFER COMMISSION FOR via GTWORLD TO ACCESS HAPPY EKKI YAKUBUReF GW,commission
07-Dec-2020,'0NIPG,07-Dec-2020,.75,,"51,739.96",VALUE ADDED TAX000013201207101800000280044205 VAT ON NIPTRANSFER FOR000013201207101800000280044205 viaGTWORLD  TO ACCESS/HAPPY EKKI YAKUBUReF:GW681976569000000050002012071016,SAVINGS ACCOUNT,GT_Bank,./static/raw/MR_IBRAHIM_ASHAFA_STATEMENT.pdf,VALUE ADDED TAX VAT ON NIPTRANSFER FOR viaGTWORLD TO ACCESS HAPPY EKKI YAKUBUReF GW,VALUE ADDED TAX VAT ON NIPTRANSFER FOR via GTWORLD TO ACCESS HAPPY EKKI YAKUBUReF GW,tax
07-Dec-2020,'0GAPS,07-Dec-2020,,"228,000.00","279,739.96",TRANSFER BETWEEN CUSTOMERS via GAPScom on Zainab Rahim 7.5M sales. 104167342 0 fromNETCONSTRUCT NIGERIA LIMITED to ASHAFAIBRAHIM ABDULLAHI REF: 0005628626104167342000000,SAVINGS ACCOUNT,GT_Bank,./static/raw/MR_IBRAHIM_ASHAFA_STATEMENT.pdf,TRANSFER BETWEEN CUSTOMERS via GAPScom on Zainab Rahim M sales fromNETCONSTRUCT NIGERIA LIMITED to ASHAFAIBRAHIM ABDULLAHI REF,TRANSFER BETWEEN CUSTOMERS via GAPScom on Zainab Rahimsales from NETCONSTRUCT NIGERIA LIMITED to ASHAFAIBRAHIM ABDULLAHI REF,transfert
07-Dec-2020,'0GWTR,07-Dec-2020,"150,000.00",,"129,739.96","TRANSFER BETWEEN CUSTOMERS Via GTWorld Zainab   REF:681976569000001500002012071053 from ASHAFA IBRAHIM ABDULLAHI  to  SALAMI, ABUBAKAR",SAVINGS ACCOUNT,GT_Bank,./static/raw/MR_IBRAHIM_ASHAFA_STATEMENT.pdf,TRANSFER BETWEEN CUSTOMERS Via GTWorld Zainab REF from ASHAFA IBRAHIM ABDULLAHI to SALAMI ABUBAKAR,TRANSFER BETWEEN CUSTOMERS Via GTWorld Zainab REF from ASHAFA IBRAHIM ABDULLAHI to SALAMI ABUBAKAR,transfert
07-Dec-2020,'0USAT,07-Dec-2020,"1,500.00",,"128,239.96",Airtime Purchase GTWORLD- 101CT0000000002199621992-2348038673032,SAVINGS ACCOUNT,GT_Bank,./static/raw/MR_IBRAHIM_ASHAFA_STATEMENT.pdf,Airtime Purchase GTWORLD CT,Airtime Purchase GTWORLD CT,utility
07-Dec-2020,'0NIPG,07-Dec-2020,"40,000.00",,"88,239.96",NIBSS Instant Payment Outward 000013201207110029000280124640 via GTWORLD December contribution TO FBN/DEMIDE ENEYAMIRE JEMILATU /26.875/REF:GW6819765690000004000020120710 f,SAVINGS ACCOUNT,GT_Bank,./static/raw/MR_IBRAHIM_ASHAFA_STATEMENT.pdf,NIBSS Instant Payment Outward via GTWORLD December contribution TO FBN DEMIDE ENEYAMIRE JEMILATU REF GW f,NIBSS Instant Payment Outward via GTWORLD December contribution TO FBN DEMIDE ENEYAMIRE JEMILATU REF GW,transfert
07-Dec-2020,'0NIPG,07-Dec-2020,25.00,,"88,214.96",COMMISSION 000013201207110029000280124640 NIP TRANSFER COMMISSION FOR 000013201207110029000280124640 via GTWORLD December contribution TO FBN/DEMIDE ENEYAMIRE JEMILATU ReF:GW681976569000000400002012071059,SAVINGS ACCOUNT,GT_Bank,./static/raw/MR_IBRAHIM_ASHAFA_STATEMENT.pdf,COMMISSION NIP TRANSFER COMMISSION FOR via GTWORLD December contribution TO FBN DEMIDE ENEYAMIRE JEMILATU ReF GW,COMMISSION NIP TRANSFER COMMISSION FOR via GTWORLD December contribution TO FBN DEMIDE ENEYAMIRE JEMILATU ReF GW,commission
07-Dec-2020,'0NIPG,07-Dec-2020,1.87,,"88,213.09",VALUE ADDED TAX 000013201207110029000280124640 VAT ON NIP TRANSFER FOR 000013201207110029000280124640 via GTWORLD December contribution TO FBN/DEMIDE ENEYAMIRE JEMILATU ReF:GW681976569000000400002012071059,SAVINGS ACCOUNT,GT_Bank,./static/raw/MR_IBRAHIM_ASHAFA_STATEMENT.pdf,VALUE ADDED TAX VAT ON NIP TRANSFER FOR via GTWORLD December contribution TO FBN DEMIDE ENEYAMIRE JEMILATU ReF GW,VALUE ADDED TAX VAT ON NIP TRANSFER FOR via GTWORLD December contribution TO FBN DEMIDE ENEYAMIRE JEMILATU ReF GW,tax
07-Dec-2020,'99990038269999,07-Dec-2020,"15,300.00",,"72,913.09",FUNDS TRANSFER  -003826- -345660-T003826 2TEP9929       LA           LANG,SAVINGS ACCOUNT,GT_Bank,./static/raw/MR_IBRAHIM_ASHAFA_STATEMENT.pdf,FUNDS TRANSFER T TEP LA LANG,FUNDS TRANSFERTEP LA LANG,utility
07-Dec-2020,'0,07-Dec-2020,100.00,,"72,813.09",STAMP DUTY CHARGE 07122020 STAMP DUTY CHARGE - 07/12/2020,SAVINGS ACCOUNT,GT_Bank,./static/raw/MR_IBRAHIM_ASHAFA_STATEMENT.pdf,STAMP DUTY CHARGE STAMP DUTY CHARGE,STAMP DUTY CHARGE STAMP DUTY CHARGE,bank_charges
08-Dec-2020,'39310039723931,08-Dec-2020,"10,000.00",,"62,813.09",CASH WITHDRAWAL FROM OUR ATM  -003972- - 754579-GTBank Apo Legislative QTRs Abuja FCNG,SAVINGS ACCOUNT,GT_Bank,./static/raw/MR_IBRAHIM_ASHAFA_STATEMENT.pdf,CASH WITHDRAWAL FROM OUR ATM GTBank Apo Legislative QTRs Abuja FCNG,CASH WITHDRAWAL FROM OUR ATM GTBank Apo Legislative QTRs Abuja FCNG,transfert
08-Dec-2020,'0GWTR,08-Dec-2020,"11,000.00",,"51,813.09",TRANSFER BETWEEN CUSTOMERS Via GTWorld Yard   REF:681976569000000110002012080906 from ASHAFA IBRAHIM ABDULLAHI  to MUHAMMAD ISMAIL RABO,SAVINGS ACCOUNT,GT_Bank,./static/raw/MR_IBRAHIM_ASHAFA_STATEMENT.pdf,TRANSFER BETWEEN CUSTOMERS Via GTWorld Yard REF from ASHAFA IBRAHIM ABDULLAHI to MUHAMMAD ISMAIL RABO,TRANSFER BETWEEN CUSTOMERS Via GTWorld Yard REF from ASHAFA IBRAHIM ABDULLAHI to MUHAMMAD ISMAIL RABO,transfert
08-Dec-2020,'0NIPG,08-Dec-2020.1,"15,000.00",,"36,813.09",NIBSS Instant Payment Outward 000013201208094656000281590024 via GTWORLD  TO ECO/HUSSAINI NAFISAT AKUKI /26.875/REF:GW6819765690000001500020120809 f,SAVINGS ACCOUNT,GT_Bank,./static/raw/MR_IBRAHIM_ASHAFA_STATEMENT.pdf,NIBSS Instant Payment Outward via GTWORLD TO ECO HUSSAINI NAFISAT AKUKI REF GW f,NIBSS Instant Payment Outward via GTWORLD TO ECO HUSSAINI NAFISAT AKUKI REF GW,transfert
08-Dec-2020,'0NIPG,08-Dec-2020,25.00,,"36,788.09",COMMISSION 000013201208094656000281590024 NIP TRANSFER COMMISSION FOR 000013201208094656000281590024 via GTWORLD  TO ECO/HUSSAINI NAFISAT AKUKI ReF:GW681976569000000150002012080945,SAVINGS ACCOUNT,GT_Bank,./static/raw/MR_IBRAHIM_ASHAFA_STATEMENT.pdf,COMMISSION NIP TRANSFER COMMISSION FOR via GTWORLD TO ECO HUSSAINI NAFISAT AKUKI ReF GW,COMMISSION NIP TRANSFER COMMISSION FOR via GTWORLD TO ECO HUSSAINI NAFISAT AKUKI ReF GW,commission
08-Dec-2020,'0NIPG,08-Dec-2020,1.87,,"36,786.22",VALUE ADDED TAX 000013201208094656000281590024 VAT ON NIP TRANSFER FOR 000013201208094656000281590024 via GTWORLD  TO ECO/HUSSAINI NAFISAT AKUKI ReF:GW681976569000000150002012080945,SAVINGS ACCOUNT,GT_Bank,./static/raw/MR_IBRAHIM_ASHAFA_STATEMENT.pdf,VALUE ADDED TAX VAT ON NIP TRANSFER FOR via GTWORLD TO ECO HUSSAINI NAFISAT AKUKI ReF GW,VALUE ADDED TAX VAT ON NIP TRANSFER FOR via GTWORLD TO ECO HUSSAINI NAFISAT AKUKI ReF GW,tax
08-Dec-2020,'0NIPG,08-Dec-2020,"7,000.00",,"29,786.22",NIBSS Instant Payment Outward 000013201208164533000282336817 via GTWORLD  TO ACCESS/GRACE EHI AYEGBA KING /26.875/REF:GW6819765690000000700020120816 f,SAVINGS ACCOUNT,GT_Bank,./static/raw/MR_IBRAHIM_ASHAFA_STATEMENT.pdf,NIBSS Instant Payment Outward via GTWORLD TO ACCESS GRACE EHI AYEGBA KING REF GW f,NIBSS Instant Payment Outward via GTWORLD TO ACCESS GRACE EHI AYEGBA KING REF GW,transfert
08-Dec-2020,'0NIPG,08-Dec-2020,25.00,,"29,761.22",COMMISSION 000013201208164533000282336817 NIP TRANSFER COMMISSION FOR 000013201208164533000282336817 via GTWORLD  TO ACCESS/GRACE EHI AYEGBA KING ReF:GW681976569000000070002012081644,SAVINGS ACCOUNT,GT_Bank,./static/raw/MR_IBRAHIM_ASHAFA_STATEMENT.pdf,COMMISSION NIP TRANSFER COMMISSION FOR via GTWORLD TO ACCESS GRACE EHI AYEGBA KING ReF GW,COMMISSION NIP TRANSFER COMMISSION FOR via GTWORLD TO ACCESS GRACE EHI AYEGBA KING ReF GW,commission
08-Dec-2020,'0NIPG,08-Dec-2020,1.87,,"29,759.35",VALUE ADDED TAX 000013201208164533000282336817 VAT ON NIP TRANSFER FOR 000013201208164533000282336817 via GTWORLD  TO ACCESS/GRACE EHI AYEGBA KING ReF:GW681976569000000070002012081644,SAVINGS ACCOUNT,GT_Bank,./static/raw/MR_IBRAHIM_ASHAFA_STATEMENT.pdf,VALUE ADDED TAX VAT ON NIP TRANSFER FOR via GTWORLD TO ACCESS GRACE EHI AYEGBA KING ReF GW,VALUE ADDED TAX VAT ON NIP TRANSFER FOR via GTWORLD TO ACCESS GRACE EHI AYEGBA KING ReF GW,tax
08-Dec-2020,'0USAT,08-Dec-2020,"1,000.00",,"28,759.35",Airtime Purchase GTWORLD- 101CT0000000002203060707-2348038673032,SAVINGS ACCOUNT,GT_Bank,./static/raw/MR_IBRAHIM_ASHAFA_STATEMENT.pdf,Airtime Purchase GTWORLD CT,Airtime Purchase GTWORLD CT,utility
08-Dec-2020,'2963320000,08-Dec-2020,"5,000.00",,"23,759.35",POS/WEB PURCHASE TRANSACTION  -296332- - 127747-SHEMA PETROLEUM LIMI   KDKDNG,SAVINGS ACCOUNT,GT_Bank,./static/raw/MR_IBRAHIM_ASHAFA_STATEMENT.pdf,POS WEB PURCHASE TRANSACTION SHEMA PETROLEUM LIMI KDKDNG,POS WEB PURCHASE TRANSACTION SHEMA PETROLEUM LIMI KDKDNG,utility
09-Dec-2020,'0NIPG,09-Dec-2020,"1,500.00",,"22,259.35",NIBSS Instant Payment Outward 000013201209123337000283444245 via GTWORLD  TO FBN/HUSSAINI MUSA /10.75/REF:GW6819765690000000150020120912  f,SAVINGS ACCOUNT,GT_Bank,./static/raw/MR_IBRAHIM_ASHAFA_STATEMENT.pdf,NIBSS Instant Payment Outward via GTWORLD TO FBN HUSSAINI MUSA REF GW f,NIBSS Instant Payment Outward via GTWORLD TO FBN HUSSAINI MUSA REF GW,transfert
09-Dec-2020,'0NIPG,09-Dec-2020,10.00,,"22,249.35",COMMISSION 000013201209123337000283444245 NIP TRANSFER COMMISSION FOR 000013201209123337000283444245 via GTWORLD  TO FBN/HUSSAINI MUSA ReF:GW681976569000000015002012091232,SAVINGS ACCOUNT,GT_Bank,./static/raw/MR_IBRAHIM_ASHAFA_STATEMENT.pdf,COMMISSION NIP TRANSFER COMMISSION FOR via GTWORLD TO FBN HUSSAINI MUSA ReF GW,COMMISSION NIP TRANSFER COMMISSION FOR via GTWORLD TO FBN HUSSAINI MUSA ReF GW,commission
09-Dec-2020,'0NIPG,09-Dec-2020,.75,,"22,248.60",VALUE ADDED TAX 000013201209123337000283444245 VAT ON NIP TRANSFER FOR 000013201209123337000283444245 via GTWORLD  TO FBN/HUSSAINI MUSA ReF:GW681976569000000015002012091232,SAVINGS ACCOUNT,GT_Bank,./static/raw/MR_IBRAHIM_ASHAFA_STATEMENT.pdf,VALUE ADDED TAX VAT ON NIP TRANSFER FOR via GTWORLD TO FBN HUSSAINI MUSA ReF GW,VALUE ADDED TAX VAT ON NIP TRANSFER FOR via GTWORLD TO FBN HUSSAINI MUSA ReF GW,tax
09-Dec-2020,'0USAT,09-Dec-2020,400.00,,"21,848.60",Airtime Purchase GTWORLD_QL- 101CT0000000002204980034-2348036417835,SAVINGS ACCOUNT,GT_Bank,./static/raw/MR_IBRAHIM_ASHAFA_STATEMENT.pdf,Airtime Purchase GTWORLD_QL CT,Airtime Purchase GTWORLDQL CT,utility
10-Dec-2020,'0NIPG,10-Dec-2020,"1,200.00",,"20,648.60",NIBSS Instant Payment Outward 000013201210075315000284538434 via GTWORLD  TO FB/NWANEKEZI NJIDEKA JANE /10.75/REF:GW6819765690000000120020121007  f,SAVINGS ACCOUNT,GT_Bank,./static/raw/MR_IBRAHIM_ASHAFA_STATEMENT.pdf,NIBSS Instant Payment Outward via GTWORLD TO FB NWANEKEZI NJIDEKA JANE REF GW f,NIBSS Instant Payment Outward via GTWORLD TO FB NWANEKEZI NJIDEKA JANE REF GW,transfert
10-Dec-2020,'0NIPG,10-Dec-2020,10.00,,"20,638.60",COMMISSION 000013201210075315000284538434 NIP TRANSFER COMMISSION FOR 000013201210075315000284538434 via GTWORLD  TO FB/NWANEKEZI NJIDEKA JANE ReF:GW681976569000000012002012100752,SAVINGS ACCOUNT,GT_Bank,./static/raw/MR_IBRAHIM_ASHAFA_STATEMENT.pdf,COMMISSION NIP TRANSFER COMMISSION FOR via GTWORLD TO FB NWANEKEZI NJIDEKA JANE ReF GW,COMMISSION NIP TRANSFER COMMISSION FOR via GTWORLD TO FB NWANEKEZI NJIDEKA JANE ReF GW,commission
10-Dec-2020,'0NIPG,10-Dec-2020,.75,,"20,637.85",VALUE ADDED TAX 000013201210075315000284538434 VAT ON NIP TRANSFER FOR 000013201210075315000284538434 via GTWORLD  TO FB/NWANEKEZI NJIDEKA JANE ReF:GW681976569000000012002012100752,SAVINGS ACCOUNT,GT_Bank,./static/raw/MR_IBRAHIM_ASHAFA_STATEMENT.pdf,VALUE ADDED TAX VAT ON NIP TRANSFER FOR via GTWORLD TO FB NWANEKEZI NJIDEKA JANE ReF GW,VALUE ADDED TAX VAT ON NIP TRANSFER FOR via GTWORLD TO FB NWANEKEZI NJIDEKA JANE ReF GW,tax
10-Dec-2020,'0GWTR,10-Dec-2020,"2,000.00",,"18,637.85","TRANSFER BETWEEN CUSTOMERS Via GTWorld REF:681976569000000020002012100753  from ASHAFA IBRAHIM ABDULLAHI  to  YOGH,BRENDA MIMI",SAVINGS ACCOUNT,GT_Bank,./static/raw/MR_IBRAHIM_ASHAFA_STATEMENT.pdf,TRANSFER BETWEEN CUSTOMERS Via GTWorld REF from ASHAFA IBRAHIM ABDULLAHI to YOGH BRENDA MIMI,TRANSFER BETWEEN CUSTOMERS Via GTWorld REF from ASHAFA IBRAHIM ABDULLAHI to YOGH BRENDA MIMI,transfert
10-Dec-2020,'0GWTR,10-Dec-2020,"1,000.00",,"17,637.85",TRANSFER BETWEEN CUSTOMERS Via GTWorldREF:681976569000000010002012101202  fromASHAFA IBRAHIM ABDULLAHI  to  EYIBO RAKIYAAHMED,SAVINGS ACCOUNT,GT_Bank,./static/raw/MR_IBRAHIM_ASHAFA_STATEMENT.pdf,TRANSFER BETWEEN CUSTOMERS Via GTWorldREF fromASHAFA IBRAHIM ABDULLAHI to EYIBO RAKIYAAHMED,TRANSFER BETWEEN CUSTOMERS Via GTWorldREF from ASHAFA IBRAHIM ABDULLAHI to EYIBO RAKIYAAHMED,transfert
10-Dec-2020,'0NIPG,10-Dec-2020,"5,000.00",,"12,637.85",NIBSS Instant Payment Outward000013201210140224000285165667 viaGTWORLD Transportation Ahmed TO UBA/YUSUFMUHAMMED EL-AMIN/10.75/REF:GW6819765690000000500020121014  f,SAVINGS ACCOUNT,GT_Bank,./static/raw/MR_IBRAHIM_ASHAFA_STATEMENT.pdf,NIBSS Instant Payment Outward viaGTWORLD Transportation Ahmed TO UBA YUSUFMUHAMMED EL AMIN REF GW f,NIBSS Instant Payment Outward via GTWORLD Transportation Ahmed TO UBA YUSUFMUHAMMED EL AMIN REF GW,transfert
10-Dec-2020,'0NIPG,10-Dec-2020,10.00,,"12,627.85",COMMISSION 000013201210140224000285165667NIP TRANSFER COMMISSION FOR000013201210140224000285165667 viaGTWORLD Transportation Ahmed TO UBA/YUSUFMUHAMMED EL-AMINReF:GW681976569000000050002012101401,SAVINGS ACCOUNT,GT_Bank,./static/raw/MR_IBRAHIM_ASHAFA_STATEMENT.pdf,COMMISSION NIP TRANSFER COMMISSION FOR viaGTWORLD Transportation Ahmed TO UBA YUSUFMUHAMMED EL AMINReF GW,COMMISSION NIP TRANSFER COMMISSION FOR via GTWORLD Transportation Ahmed TO UBA YUSUFMUHAMMED EL AMINReF GW,commission
10-Dec-2020,'0NIPG,10-Dec-2020,.75,,"12,627.10",VALUE ADDED TAX000013201210140224000285165667 VAT ON NIPTRANSFER FOR000013201210140224000285165667 viaGTWORLD Transportation Ahmed TO UBA/YUSUFMUHAMMED EL-AMINReF:GW681976569000000050002012101401,SAVINGS ACCOUNT,GT_Bank,./static/raw/MR_IBRAHIM_ASHAFA_STATEMENT.pdf,VALUE ADDED TAX VAT ON NIPTRANSFER FOR viaGTWORLD Transportation Ahmed TO UBA YUSUFMUHAMMED EL AMINReF GW,VALUE ADDED TAX VAT ON NIPTRANSFER FOR via GTWORLD Transportation Ahmed TO UBA YUSUFMUHAMMED EL AMINReF GW,tax
10-Dec-2020,'99998596939999,10-Dec-2020,"2,000.00",,"10,627.10",CASH WITHDRAWAL FROM OTHER ATM  -859693- -353850-SWTWEMsnkABUJANG,SAVINGS ACCOUNT,GT_Bank,./static/raw/MR_IBRAHIM_ASHAFA_STATEMENT.pdf,CASH WITHDRAWAL FROM OTHER ATM SWTWEMsnkABUJANG,CASH WITHDRAWAL FROM OTHER ATM SWTWEMsnkABUJANG,cash
11-Dec-2020,'0NIPT,11-Dec-2020,,"120,000.00","130,627.10",TRANSFER BETWEEN CUSTOMERS000010201211072455111344405872|REF595406636 BO abdullahi ibrahim IFO ASHAFAIBRA|595406636||abdullahi ibrahimREF:000010201211072455111344405872,SAVINGS ACCOUNT,GT_Bank,./static/raw/MR_IBRAHIM_ASHAFA_STATEMENT.pdf,TRANSFER BETWEEN CUSTOMERS REF BO abdullahi ibrahim IFO ASHAFAIBRA abdullahi ibrahimREF,TRANSFER BETWEEN CUSTOMERS REF BO abdullahi ibrahim IFO ASHAFAIBRA abdullahi ibrahimREF,transfert
11-Dec-2020,'0NIPG,11-Dec-2020,"30,000.00",,"100,627.10",NIBSS Instant Payment Outward000013201211092053000286266583 viaGTWORLD December contribution TO FBN/DEMIDEENEYAMIRE JEMILATU/26.875/REF:GW6819765690000003000020121109f,SAVINGS ACCOUNT,GT_Bank,./static/raw/MR_IBRAHIM_ASHAFA_STATEMENT.pdf,NIBSS Instant Payment Outward viaGTWORLD December contribution TO FBN DEMIDEENEYAMIRE JEMILATU REF GW f,NIBSS Instant Payment Outward via GTWORLD December contribution TO FBN DEMIDEENEYAMIRE JEMILATU REF GW,transfert
11-Dec-2020,'0NIPG,11-Dec-2020,25.00,,"100,602.10",COMMISSION 000013201211092053000286266583NIP TRANSFER COMMISSION FOR000013201211092053000286266583 viaGTWORLD December contribution TO FBN/DEMIDEENEYAMIRE JEMILATU ReF:GW681976569000000300002012110919,SAVINGS ACCOUNT,GT_Bank,./static/raw/MR_IBRAHIM_ASHAFA_STATEMENT.pdf,COMMISSION NIP TRANSFER COMMISSION FOR viaGTWORLD December contribution TO FBN DEMIDEENEYAMIRE JEMILATU ReF GW,COMMISSION NIP TRANSFER COMMISSION FOR via GTWORLD December contribution TO FBN DEMIDEENEYAMIRE JEMILATU ReF GW,commission
11-Dec-2020,'0NIPG,11-Dec-2020,1.87,,"100,600.23",VALUE ADDED TAX 000013201211092053000286266583 VAT ON NIP TRANSFER FOR 000013201211092053000286266583 via GTWORLD December contribution TO FBN/DEMIDE ENEYAMIRE JEMILATU ReF:GW681976569000000300002012110919,SAVINGS ACCOUNT,GT_Bank,./static/raw/MR_IBRAHIM_ASHAFA_STATEMENT.pdf,VALUE ADDED TAX VAT ON NIP TRANSFER FOR via GTWORLD December contribution TO FBN DEMIDE ENEYAMIRE JEMILATU ReF GW,VALUE ADDED TAX VAT ON NIP TRANSFER FOR via GTWORLD December contribution TO FBN DEMIDE ENEYAMIRE JEMILATU ReF GW,tax
11-Dec-2020,'0GWTR,11-Dec-2020,"20,000.00",,"80,600.23","TRANSFER BETWEEN CUSTOMERS Via GTWorld REF:681976569000000200002012110921  from ASHAFA IBRAHIM ABDULLAHI  to  MUNDU HAUWA, MOHAMMED",SAVINGS ACCOUNT,GT_Bank,./static/raw/MR_IBRAHIM_ASHAFA_STATEMENT.pdf,TRANSFER BETWEEN CUSTOMERS Via GTWorld REF from ASHAFA IBRAHIM ABDULLAHI to MUNDU HAUWA MOHAMMED,TRANSFER BETWEEN CUSTOMERS Via GTWorld REF from ASHAFA IBRAHIM ABDULLAHI to MUNDU HAUWA MOHAMMED,transfert
11-Dec-2020,'0NIPG,11-Dec-2020,"20,000.00",,"60,600.23",NIBSS Instant Payment Outward 000013201211092300000286270470 via GTWORLD  TO UBA/ALIYU HAUWA /26.875/REF:GW6819765690000002000020121109 f,SAVINGS ACCOUNT,GT_Bank,./static/raw/MR_IBRAHIM_ASHAFA_STATEMENT.pdf,NIBSS Instant Payment Outward via GTWORLD TO UBA ALIYU HAUWA REF GW f,NIBSS Instant Payment Outward via GTWORLD TO UBA ALIYU HAUWA REF GW,transfert
11-Dec-2020,'0NIPG,11-Dec-2020,25.00,,"60,575.23",COMMISSION 000013201211092300000286270470 NIP TRANSFER COMMISSION FOR 000013201211092300000286270470 via GTWORLD  TO UBA/ALIYU HAUWA ReF:GW681976569000000200002012110921,SAVINGS ACCOUNT,GT_Bank,./static/raw/MR_IBRAHIM_ASHAFA_STATEMENT.pdf,COMMISSION NIP TRANSFER COMMISSION FOR via GTWORLD TO UBA ALIYU HAUWA ReF GW,COMMISSION NIP TRANSFER COMMISSION FOR via GTWORLD TO UBA ALIYU HAUWA ReF GW,commission
11-Dec-2020,'0NIPG,11-Dec-2020,1.87,,"60,573.36",VALUE ADDED TAX 000013201211092300000286270470 VAT ON NIP TRANSFER FOR 000013201211092300000286270470 via GTWORLD  TO UBA/ALIYU HAUWA ReF:GW681976569000000200002012110921,SAVINGS ACCOUNT,GT_Bank,./static/raw/MR_IBRAHIM_ASHAFA_STATEMENT.pdf,VALUE ADDED TAX VAT ON NIP TRANSFER FOR via GTWORLD TO UBA ALIYU HAUWA ReF GW,VALUE ADDED TAX VAT ON NIP TRANSFER FOR via GTWORLD TO UBA ALIYU HAUWA ReF GW,tax
11-Dec-2020,'0NIPG,11-Dec-2020,"13,000.00",,"47,573.36",NIBSS Instant Payment Outward 000013201211092427000286273071 via GTWORLD  TO UBA/YAKUBU ASHAFA ABDULLAHI /26.875/REF:GW6819765690000001300020121109 f,SAVINGS ACCOUNT,GT_Bank,./static/raw/MR_IBRAHIM_ASHAFA_STATEMENT.pdf,NIBSS Instant Payment Outward via GTWORLD TO UBA YAKUBU ASHAFA ABDULLAHI REF GW f,NIBSS Instant Payment Outward via GTWORLD TO UBA YAKUBU ASHAFA ABDULLAHI REF GW,transfert
11-Dec-2020,'0NIPG,11-Dec-2020,25.00,,"47,548.36",COMMISSION 000013201211092427000286273071 NIP TRANSFER COMMISSION FOR 000013201211092427000286273071 via GTWORLD  TO UBA/YAKUBU ASHAFAABDULLAHI ReF:GW681976569000000130002012110923,SAVINGS ACCOUNT,GT_Bank,./static/raw/MR_IBRAHIM_ASHAFA_STATEMENT.pdf,COMMISSION NIP TRANSFER COMMISSION FOR via GTWORLD TO UBA YAKUBU ASHAFAABDULLAHI ReF GW,COMMISSION NIP TRANSFER COMMISSION FOR via GTWORLD TO UBA YAKUBU ASHAFAABDULLAHI ReF GW,commission
11-Dec-2020,'0NIPG,11-Dec-2020,1.87,,"47,546.49",VALUE ADDED TAX 000013201211092427000286273071 VAT ON NIP TRANSFER FOR 000013201211092427000286273071 via GTWORLD  TO UBA/YAKUBU ASHAFA ABDULLAHI ReF:GW681976569000000130002012110923,SAVINGS ACCOUNT,GT_Bank,./static/raw/MR_IBRAHIM_ASHAFA_STATEMENT.pdf,VALUE ADDED TAX VAT ON NIP TRANSFER FOR via GTWORLD TO UBA YAKUBU ASHAFA ABDULLAHI ReF GW,VALUE ADDED TAX VAT ON NIP TRANSFER FOR via GTWORLD TO UBA YAKUBU ASHAFA ABDULLAHI ReF GW,tax
11-Dec-2020,'0USAT,11-Dec-2020,400.00,,"47,146.49",Airtime Purchase GTWORLD- 101CT0000000002209623977-2348168413945,SAVINGS ACCOUNT,GT_Bank,./static/raw/MR_IBRAHIM_ASHAFA_STATEMENT.pdf,Airtime Purchase GTWORLD CT,Airtime Purchase GTWORLD CT,utility
11-Dec-2020,'0USAT,11-Dec-2020,300.00,,"46,846.49",Airtime Purchase GTWORLD- 101CT0000000002209627130-2348146523935,SAVINGS ACCOUNT,GT_Bank,./static/raw/MR_IBRAHIM_ASHAFA_STATEMENT.pdf,Airtime Purchase GTWORLD CT,Airtime Purchase GTWORLD CT,utility
11-Dec-2020,'0GWTR,11-Dec-2020,"1,000.00",,"45,846.49","TRANSFER BETWEEN CUSTOMERS Via GTWorld REF:681976569000000010002012110954  from ASHAFA IBRAHIM ABDULLAHI  to  AKPAN, SARAH PAUL",SAVINGS ACCOUNT,GT_Bank,./static/raw/MR_IBRAHIM_ASHAFA_STATEMENT.pdf,TRANSFER BETWEEN CUSTOMERS Via GTWorld REF from ASHAFA IBRAHIM ABDULLAHI to AKPAN SARAH PAUL,TRANSFER BETWEEN CUSTOMERS Via GTWorld REF from ASHAFA IBRAHIM ABDULLAHI to AKPAN SARAH PAUL,transfert
11-Dec-2020,'0GWTR,11-Dec-2020,"2,000.00",,"43,846.49",TRANSFER BETWEEN CUSTOMERS Via GTWorld REF:681976569000000020002012111206  from ASHAFA IBRAHIM ABDULLAHI  to  MUHAMMAD ISMAIL RABO,SAVINGS ACCOUNT,GT_Bank,./static/raw/MR_IBRAHIM_ASHAFA_STATEMENT.pdf,TRANSFER BETWEEN CUSTOMERS Via GTWorld REF from ASHAFA IBRAHIM ABDULLAHI to MUHAMMAD ISMAIL RABO,TRANSFER BETWEEN CUSTOMERS Via GTWorld REF from ASHAFA IBRAHIM ABDULLAHI to MUHAMMAD ISMAIL RABO,transfert
11-Dec-2020,'0NIPG,11-Dec-2020,"2,000.00",,"41,846.49",NIBSS Instant Payment Outward 000013201211162831000287069304 via GTWORLD  TO UBA/YAKUBU ASHAFA ABDULLAHI /10.75/REF:GW6819765690000000200020121116  f,SAVINGS ACCOUNT,GT_Bank,./static/raw/MR_IBRAHIM_ASHAFA_STATEMENT.pdf,NIBSS Instant Payment Outward via GTWORLD TO UBA YAKUBU ASHAFA ABDULLAHI REF GW f,NIBSS Instant Payment Outward via GTWORLD TO UBA YAKUBU ASHAFA ABDULLAHI REF GW,transfert
11-Dec-2020,'0NIPG,11-Dec-2020,10.00,,"41,836.49",COMMISSION 000013201211162831000287069304 NIP TRANSFER COMMISSION FOR 000013201211162831000287069304 via GTWORLD  TO UBA/YAKUBU ASHAFA ABDULLAHI ReF:GW681976569000000020002012111627,SAVINGS ACCOUNT,GT_Bank,./static/raw/MR_IBRAHIM_ASHAFA_STATEMENT.pdf,COMMISSION NIP TRANSFER COMMISSION FOR via GTWORLD TO UBA YAKUBU ASHAFA ABDULLAHI ReF GW,COMMISSION NIP TRANSFER COMMISSION FOR via GTWORLD TO UBA YAKUBU ASHAFA ABDULLAHI ReF GW,commission
11-Dec-2020,'0NIPG,11-Dec-2020,.75,,"41,835.74",VALUE ADDED TAX 000013201211162831000287069304 VAT ON NIP TRANSFER FOR 000013201211162831000287069304 via GTWORLD  TO UBA/YAKUBU ASHAFA ABDULLAHIReF:GW681976569000000020002012111627,SAVINGS ACCOUNT,GT_Bank,./static/raw/MR_IBRAHIM_ASHAFA_STATEMENT.pdf,VALUE ADDED TAX VAT ON NIP TRANSFER FOR via GTWORLD TO UBA YAKUBU ASHAFA ABDULLAHIReF GW,VALUE ADDED TAX VAT ON NIP TRANSFER FOR via GTWORLD TO UBA YAKUBU ASHAFA ABDULLAHIReF GW,tax
11-Dec-2020,'2188020000,11-Dec-2020,"15,050.00",,"26,785.74",POS/WEB PURCHASE TRANSACTION  -218802- - 048552-AZMAN OIL AND GAS LI   FC           FCNG,SAVINGS ACCOUNT,GT_Bank,./static/raw/MR_IBRAHIM_ASHAFA_STATEMENT.pdf,POS WEB PURCHASE TRANSACTION AZMAN OIL AND GAS LI FC FCNG,POS WEB PURCHASE TRANSACTION AZMAN OIL AND GAS LI FC FCNG,utility
11-Dec-2020,'0NIPG,11-Dec-2020,"15,000.00",,"11,785.74",NIBSS Instant Payment Outward 000013201211181647000287266476 via GTWORLD  TO UBA/ABUBAKAR ALIYU /26.875/REF:GW6819765690000001500020121118 f,SAVINGS ACCOUNT,GT_Bank,./static/raw/MR_IBRAHIM_ASHAFA_STATEMENT.pdf,NIBSS Instant Payment Outward via GTWORLD TO UBA ABUBAKAR ALIYU REF GW f,NIBSS Instant Payment Outward via GTWORLD TO UBA ABUBAKAR ALIYU REF GW,transfert
11-Dec-2020,'0NIPG,11-Dec-2020,25.00,,"11,760.74",COMMISSION 000013201211181647000287266476 NIP TRANSFER COMMISSION FOR 000013201211181647000287266476 via GTWORLD  TO UBA/ABUBAKAR ALIYU ReF:GW681976569000000150002012111815,SAVINGS ACCOUNT,GT_Bank,./static/raw/MR_IBRAHIM_ASHAFA_STATEMENT.pdf,COMMISSION NIP TRANSFER COMMISSION FOR via GTWORLD TO UBA ABUBAKAR ALIYU ReF GW,COMMISSION NIP TRANSFER COMMISSION FOR via GTWORLD TO UBA ABUBAKAR ALIYU ReF GW,commission
11-Dec-2020,'0NIPG,11-Dec-2020,1.87,,"11,758.87",VALUE ADDED TAX 000013201211181647000287266476 VAT ON NIP TRANSFER FOR 000013201211181647000287266476 via GTWORLD  TO UBA/ABUBAKAR ALIYU ReF:GW681976569000000150002012111815,SAVINGS ACCOUNT,GT_Bank,./static/raw/MR_IBRAHIM_ASHAFA_STATEMENT.pdf,VALUE ADDED TAX VAT ON NIP TRANSFER FOR via GTWORLD TO UBA ABUBAKAR ALIYU ReF GW,VALUE ADDED TAX VAT ON NIP TRANSFER FOR via GTWORLD TO UBA ABUBAKAR ALIYU ReF GW,tax
11-Dec-2020,'0,11-Dec-2020,50.00,,"11,708.87",STAMP DUTY CHARGE 11122020 STAMP DUTY CHARGE - 11/12/2020,SAVINGS ACCOUNT,GT_Bank,./static/raw/MR_IBRAHIM_ASHAFA_STATEMENT.pdf,STAMP DUTY CHARGE STAMP DUTY CHARGE,STAMP DUTY CHARGE STAMP DUTY CHARGE,bank_charges
12-Dec-2020,'0NIPG,12-Dec-2020,"2,000.00",,"9,708.87",NIBSS Instant Payment Outward 000013201212021333000287587615 via GTWORLD  TO ACCESS/ROLI  EDUN /10.75/REF:GW6819765690000000200020121202  f,SAVINGS ACCOUNT,GT_Bank,./static/raw/MR_IBRAHIM_ASHAFA_STATEMENT.pdf,NIBSS Instant Payment Outward via GTWORLD TO ACCESS ROLI EDUN REF GW f,NIBSS Instant Payment Outward via GTWORLD TO ACCESS ROLI EDUN REF GW,transfert
12-Dec-2020,'0NIPG,12-Dec-2020,10.00,,"9,698.87",COMMISSION 000013201212021333000287587615 NIP TRANSFER COMMISSION FOR 000013201212021333000287587615 via GTWORLD  TO ACCESS/ROLI  EDUN ReF:GW681976569000000020002012120212,SAVINGS ACCOUNT,GT_Bank,./static/raw/MR_IBRAHIM_ASHAFA_STATEMENT.pdf,COMMISSION NIP TRANSFER COMMISSION FOR via GTWORLD TO ACCESS ROLI EDUN ReF GW,COMMISSION NIP TRANSFER COMMISSION FOR via GTWORLD TO ACCESS ROLI EDUN ReF GW,commission
12-Dec-2020,'0NIPG,12-Dec-2020,.75,,"9,698.12",VALUE ADDED TAX 000013201212021333000287587615 VAT ON NIP TRANSFER FOR 000013201212021333000287587615 via GTWORLD  TO ACCESS/ROLI  EDUN ReF:GW681976569000000020002012120212,SAVINGS ACCOUNT,GT_Bank,./static/raw/MR_IBRAHIM_ASHAFA_STATEMENT.pdf,VALUE ADDED TAX VAT ON NIP TRANSFER FOR via GTWORLD TO ACCESS ROLI EDUN ReF GW,VALUE ADDED TAX VAT ON NIP TRANSFER FOR via GTWORLD TO ACCESS ROLI EDUN ReF GW,tax
12-Dec-2020,'0GWTR,12-Dec-2020,"2,000.00",,"7,698.12","TRANSFER BETWEEN CUSTOMERS Via GTWorld REF:681976569000000020002012121920  fromASHAFA IBRAHIM ABDULLAHI  to  ABDULLATIF, RUKAYYA",SAVINGS ACCOUNT,GT_Bank,./static/raw/MR_IBRAHIM_ASHAFA_STATEMENT.pdf,TRANSFER BETWEEN CUSTOMERS Via GTWorld REF fromASHAFA IBRAHIM ABDULLAHI to ABDULLATIF RUKAYYA,TRANSFER BETWEEN CUSTOMERS Via GTWorld REF from ASHAFA IBRAHIM ABDULLAHI to ABDULLATIF RUKAYYA,transfert
13-Dec-2020,'39840089533984,12-Dec-2020,"6,000.00",,"1,698.12",CASH WITHDRAWAL FROM OUR ATM  -008953- - 560487-GTBank Gwarinpa        ABUJA        FCNG,SAVINGS ACCOUNT,GT_Bank,./static/raw/MR_IBRAHIM_ASHAFA_STATEMENT.pdf,CASH WITHDRAWAL FROM OUR ATM GTBank Gwarinpa ABUJA FCNG,CASH WITHDRAWAL FROM OUR ATM GTBank Gwarinpa ABUJA FCNG,transfert
13-Dec-2020,'1621340000,13-Dec-2020,"3,000.00",,"-1,301.88",POS/WEB PURCHASE TRANSACTION  -162134- - 409230-AZMAN OIL AND GAS LI   FC           FCNG,SAVINGS ACCOUNT,GT_Bank,./static/raw/MR_IBRAHIM_ASHAFA_STATEMENT.pdf,POS WEB PURCHASE TRANSACTION AZMAN OIL AND GAS LI FC FCNG,POS WEB PURCHASE TRANSACTION AZMAN OIL AND GAS LI FC FCNG,utility
13-Dec-2020,'0USGT,13-Dec-2020,"5,000.00",,"-6,301.88",TRANSFER BETWEEN CUSTOMERS Via USSD GTBank Transfer 000000006810976569321035919900000050002020 12132102  from ASHAFA IBRAHIM ABDULLAHI  to MUHAMMAD ISMAIL RABO,SAVINGS ACCOUNT,GT_Bank,./static/raw/MR_IBRAHIM_ASHAFA_STATEMENT.pdf,TRANSFER BETWEEN CUSTOMERS Via USSD GTBank Transfer from ASHAFA IBRAHIM ABDULLAHI to MUHAMMAD ISMAIL RABO,TRANSFER BETWEEN CUSTOMERS Via USSD GTBank Transfer from ASHAFA IBRAHIM ABDULLAHI to MUHAMMAD ISMAIL RABO,transfert
13-Dec-2020,'0USGT,13-Dec-2020,20.00,,"-6,321.88",COMMISSION GTBank Transfer Commission : 08038673032 ASHAFA IBRAHIM ABDULLAHI to MUHAMMAD ISMAIL RABO 000000006810976569321035919900000050002020 12132102,SAVINGS ACCOUNT,GT_Bank,./static/raw/MR_IBRAHIM_ASHAFA_STATEMENT.pdf,COMMISSION GTBank Transfer Commission ASHAFA IBRAHIM ABDULLAHI to MUHAMMAD ISMAIL RABO,COMMISSION GTBank Transfer Commission ASHAFA IBRAHIM ABDULLAHI to MUHAMMAD ISMAIL RABO,transfert
13-Dec-2020,'0USGT,13-Dec-2020,1.50,,"-6,323.38",VALUE ADDED TAX GTBank Transfer VAT : 08038673032 ASHAFA IBRAHIM ABDULLAHI to MUHAMMAD ISMAIL RABO 000000006810976569321035919900000050002020 12132102,SAVINGS ACCOUNT,GT_Bank,./static/raw/MR_IBRAHIM_ASHAFA_STATEMENT.pdf,VALUE ADDED TAX GTBank Transfer VAT ASHAFA IBRAHIM ABDULLAHI to MUHAMMAD ISMAIL RABO,VALUE ADDED TAX GTBank Transfer VAT ASHAFA IBRAHIM ABDULLAHI to MUHAMMAD ISMAIL RABO,tax
14-Dec-2020,'99998485649999,14-Dec-2020,"7,000.00",,"-13,323.38",CASH WITHDRAWAL FROM OTHER ATM  - 848564- -216325-000000000000932 Boling Abuja NG,SAVINGS ACCOUNT,GT_Bank,./static/raw/MR_IBRAHIM_ASHAFA_STATEMENT.pdf,CASH WITHDRAWAL FROM OTHER ATM Boling Abuja NG,CASH WITHDRAWAL FROM OTHER ATM Boling Abuja NG,cash
14-Dec-2020,'0USAT,14-Dec-2020,900.00,,"-14,223.38",Airtime Purchase GTWORLD_QL- 101CT0000000002217420574-2348038673032,SAVINGS ACCOUNT,GT_Bank,./static/raw/MR_IBRAHIM_ASHAFA_STATEMENT.pdf,Airtime Purchase GTWORLD_QL CT,Airtime Purchase GTWORLDQL CT,utility
15-Dec-2020,'0NIPG,15-Dec-2020,"4,000.00",,"-18,223.38",NIBSS Instant Payment Outward 000013201215113430000292092013 via GTWORLD  TO UBA/YUSUF HASSAN /10.75/REF:GW6819765690000000400020121511  f,SAVINGS ACCOUNT,GT_Bank,./static/raw/MR_IBRAHIM_ASHAFA_STATEMENT.pdf,NIBSS Instant Payment Outward via GTWORLD TO UBA YUSUF HASSAN REF GW f,NIBSS Instant Payment Outward via GTWORLD TO UBA YUSUF HASSAN REF GW,transfert
15-Dec-2020,'0NIPG,15-Dec-2020,10.00,,"-18,233.38",COMMISSION 000013201215113430000292092013 NIP TRANSFER COMMISSION FOR 000013201215113430000292092013 via GTWORLD  TO UBA/YUSUF HASSAN ReF:GW681976569000000040002012151132,SAVINGS ACCOUNT,GT_Bank,./static/raw/MR_IBRAHIM_ASHAFA_STATEMENT.pdf,COMMISSION NIP TRANSFER COMMISSION FOR via GTWORLD TO UBA YUSUF HASSAN ReF GW,COMMISSION NIP TRANSFER COMMISSION FOR via GTWORLD TO UBA YUSUF HASSAN ReF GW,commission
15-Dec-2020,'0NIPG,15-Dec-2020,.75,,"-18,234.13",VALUE ADDED TAX 000013201215113430000292092013 VAT ON NIPTRANSFER FOR 000013201215113430000292092013 via GTWORLD  TO UBA/YUSUF HASSAN ReF:GW681976569000000040002012151132,SAVINGS ACCOUNT,GT_Bank,./static/raw/MR_IBRAHIM_ASHAFA_STATEMENT.pdf,VALUE ADDED TAX VAT ON NIPTRANSFER FOR via GTWORLD TO UBA YUSUF HASSAN ReF GW,VALUE ADDED TAX VAT ON NIPTRANSFER FOR via GTWORLD TO UBA YUSUF HASSAN ReF GW,tax
15-Dec-2020,'0NIPG,15-Dec-2020,"3,000.00",,"-21,234.13",NIBSS Instant Payment Outward 000013201215114855000292121657 via GTWORLD  TO UNION/ABDULLAHI MUHAMMAD H /10.75/REF:GW6819765690000000300020121511  f,SAVINGS ACCOUNT,GT_Bank,./static/raw/MR_IBRAHIM_ASHAFA_STATEMENT.pdf,NIBSS Instant Payment Outward via GTWORLD TO UNION ABDULLAHI MUHAMMAD H REF GW f,NIBSS Instant Payment Outward via GTWORLD TO UNION ABDULLAHI MUHAMMADREF GW,transfert
15-Dec-2020,'0NIPG,15-Dec-2020,10.00,,"-21,244.13",COMMISSION 000013201215114855000292121657 NIP TRANSFER COMMISSION FOR 000013201215114855000292121657 via GTWORLD  TO UNION/ABDULLAHI MUHAMMAD H ReF:GW681976569000000030002012151147,SAVINGS ACCOUNT,GT_Bank,./static/raw/MR_IBRAHIM_ASHAFA_STATEMENT.pdf,COMMISSION NIP TRANSFER COMMISSION FOR via GTWORLD TO UNION ABDULLAHI MUHAMMAD H ReF GW,COMMISSION NIP TRANSFER COMMISSION FOR via GTWORLD TO UNION ABDULLAHI MUHAMMADReF GW,commission
15-Dec-2020,'0NIPG,15-Dec-2020,.75,,"-21,244.88",VALUE ADDED TAX 000013201215114855000292121657 VAT ON NIP TRANSFER FOR 000013201215114855000292121657 via GTWORLD  TO UNION/ABDULLAHI MUHAMMAD H ReF:GW681976569000000030002012151147,SAVINGS ACCOUNT,GT_Bank,./static/raw/MR_IBRAHIM_ASHAFA_STATEMENT.pdf,VALUE ADDED TAX VAT ON NIP TRANSFER FOR via GTWORLD TO UNION ABDULLAHI MUHAMMAD H ReF GW,VALUE ADDED TAX VAT ON NIP TRANSFER FOR via GTWORLD TO UNION ABDULLAHI MUHAMMADReF GW,tax
16-Dec-2020,'0USAT,16-Dec-2020,"1,000.00",,"-22,244.88",Airtime Purchase GTWORLD_QL- 101CT0000000002221605923-2348038673032,SAVINGS ACCOUNT,GT_Bank,./static/raw/MR_IBRAHIM_ASHAFA_STATEMENT.pdf,Airtime Purchase GTWORLD_QL CT,Airtime Purchase GTWORLDQL CT,utility
16-Dec-2020,'0NIPG,16-Dec-2020,"6,000.00",,"-28,244.88",NIBSS Instant Payment Outward 000013201216093913000293496178 via GTWORLD  TO UBA/YUSUF HASSAN /26.875/REF:GW6819765690000000600020121609 f,SAVINGS ACCOUNT,GT_Bank,./static/raw/MR_IBRAHIM_ASHAFA_STATEMENT.pdf,NIBSS Instant Payment Outward via GTWORLD TO UBA YUSUF HASSAN REF GW f,NIBSS Instant Payment Outward via GTWORLD TO UBA YUSUF HASSAN REF GW,transfert
16-Dec-2020,'0NIPG,16-Dec-2020,25.00,,"-28,269.88",COMMISSION 000013201216093913000293496178 NIP TRANSFER COMMISSION FOR 000013201216093913000293496178 via GTWORLD  TO UBA/YUSUF HASSAN ReF:GW681976569000000060002012160938,SAVINGS ACCOUNT,GT_Bank,./static/raw/MR_IBRAHIM_ASHAFA_STATEMENT.pdf,COMMISSION NIP TRANSFER COMMISSION FOR via GTWORLD TO UBA YUSUF HASSAN ReF GW,COMMISSION NIP TRANSFER COMMISSION FOR via GTWORLD TO UBA YUSUF HASSAN ReF GW,commission
16-Dec-2020,'0NIPG,16-Dec-2020,1.87,,"-28,271.75",VALUE ADDED TAX 000013201216093913000293496178 VAT ON NIP TRANSFER FOR 000013201216093913000293496178 via GTWORLD  TO UBA/YUSUF HASSANReF:GW681976569000000060002012160938,SAVINGS ACCOUNT,GT_Bank,./static/raw/MR_IBRAHIM_ASHAFA_STATEMENT.pdf,VALUE ADDED TAX VAT ON NIP TRANSFER FOR via GTWORLD TO UBA YUSUF HASSANReF GW,VALUE ADDED TAX VAT ON NIP TRANSFER FOR via GTWORLD TO UBA YUSUF HASSANReF GW,tax
16-Dec-2020,'0NIPT,16-Dec-2020,,"34,000.00","5,728.25",TRANSFER BETWEEN CUSTOMERS000007201216121942000034858062|NIP/TRSF IFOASHAFA IBRAHIMABDULLAHI|N01916728003||IBRAHIM ABDULLAHIASHAFAREF:000007201216121942000034858062,SAVINGS ACCOUNT,GT_Bank,./static/raw/MR_IBRAHIM_ASHAFA_STATEMENT.pdf,TRANSFER BETWEEN CUSTOMERS NIP TRSF IFOASHAFA IBRAHIMABDULLAHI N IBRAHIM ABDULLAHIASHAFAREF,TRANSFER BETWEEN CUSTOMERS NIP TRSF IFOASHAFA IBRAHIMABDULLAHIIBRAHIM ABDULLAHIASHAFAREF,transfert
16-Dec-2020,'0GWTR,16-Dec-2020,"14,000.00",,"-8,271.75",TRANSFER BETWEEN CUSTOMERS Via GTWorldREF:681976569000000140002012161250  fromASHAFA IBRAHIM ABDULLAHI  to  MUHAMMADISMAIL RABO,SAVINGS ACCOUNT,GT_Bank,./static/raw/MR_IBRAHIM_ASHAFA_STATEMENT.pdf,TRANSFER BETWEEN CUSTOMERS Via GTWorldREF fromASHAFA IBRAHIM ABDULLAHI to MUHAMMADISMAIL RABO,TRANSFER BETWEEN CUSTOMERS Via GTWorldREF from ASHAFA IBRAHIM ABDULLAHI to MUHAMMADISMAIL RABO,transfert
16-Dec-2020,'0,16-Dec-2020,50.00,,"-8,321.75",STAMP DUTY CHARGE 16122020 STAMP DUTYCHARGE - 16/12/2020,SAVINGS ACCOUNT,GT_Bank,./static/raw/MR_IBRAHIM_ASHAFA_STATEMENT.pdf,STAMP DUTY CHARGE STAMP DUTYCHARGE,STAMP DUTY CHARGE STAMP DUTYCHARGE,bank_charges
17-Dec-2020,'0NIPT,17-Dec-2020,,"110,004.95","101,683.20",TRANSFER BETWEEN CUSTOMERS000004201217150851200081109615|TUDIBG/UTO/NetC Dec Sal Ashsfa|200081109615||REF:000004201217150851200081109615,SAVINGS ACCOUNT,GT_Bank,./static/raw/MR_IBRAHIM_ASHAFA_STATEMENT.pdf,TRANSFER BETWEEN CUSTOMERS TUDIBG UTO NetC Dec Sal Ashsfa REF,TRANSFER BETWEEN CUSTOMERS TUDIBG UTO NetC Dec Sal Ashsfa REF,transfert
17-Dec-2020,'0NIPG,17-Dec-2020,"30,000.00",,"71,683.20",NIBSS Instant Payment Outward000013201217153128000295748190 viaGTWORLD  TO FBN/DEMIDE ENEYAMIREJEMILATU/26.875/REF:GW6819765690000003000020121715f,SAVINGS ACCOUNT,GT_Bank,./static/raw/MR_IBRAHIM_ASHAFA_STATEMENT.pdf,NIBSS Instant Payment Outward viaGTWORLD TO FBN DEMIDE ENEYAMIREJEMILATU REF GW f,NIBSS Instant Payment Outward via GTWORLD TO FBN DEMIDE ENEYAMIREJEMILATU REF GW,transfert
17-Dec-2020,'0NIPG,17-Dec-2020,25.00,,"71,658.20",COMMISSION 000013201217153128000295748190NIP TRANSFER COMMISSION FOR000013201217153128000295748190 viaGTWORLD  TO FBN/DEMIDE ENEYAMIREJEMILATUReF:GW681976569000000300002012171530,SAVINGS ACCOUNT,GT_Bank,./static/raw/MR_IBRAHIM_ASHAFA_STATEMENT.pdf,COMMISSION NIP TRANSFER COMMISSION FOR viaGTWORLD TO FBN DEMIDE ENEYAMIREJEMILATUReF GW,COMMISSION NIP TRANSFER COMMISSION FOR via GTWORLD TO FBN DEMIDE ENEYAMIREJEMILATUReF GW,commission
17-Dec-2020,'0NIPG,17-Dec-2020,1.87,,"71,656.33",VALUE ADDED TAX000013201217153128000295748190 VAT ON NIPTRANSFER FOR000013201217153128000295748190 viaGTWORLD  TO FBN/DEMIDE ENEYAMIREJEMILATUReF:GW681976569000000300002012171530,SAVINGS ACCOUNT,GT_Bank,./static/raw/MR_IBRAHIM_ASHAFA_STATEMENT.pdf,VALUE ADDED TAX VAT ON NIPTRANSFER FOR viaGTWORLD TO FBN DEMIDE ENEYAMIREJEMILATUReF GW,VALUE ADDED TAX VAT ON NIPTRANSFER FOR via GTWORLD TO FBN DEMIDE ENEYAMIREJEMILATUReF GW,tax
17-Dec-2020,'0NIPG,17-Dec-2020,"20,000.00",,"51,656.33",NIBSS Instant Payment Outward000013201217153531000295756187 viaGTWORLD  TO ZBN/AISHA NAMAMA ZUBAIRU /26.875/REF:GW6819765690000002000020121715 f,SAVINGS ACCOUNT,GT_Bank,./static/raw/MR_IBRAHIM_ASHAFA_STATEMENT.pdf,NIBSS Instant Payment Outward viaGTWORLD TO ZBN AISHA NAMAMA ZUBAIRU REF GW f,NIBSS Instant Payment Outward via GTWORLD TO ZBN AISHA NAMAMA ZUBAIRU REF GW,transfert
17-Dec-2020,'0NIPG,17-Dec-2020,25.00,,"51,631.33",COMMISSION 000013201217153531000295756187 NIP TRANSFER COMMISSION FOR 000013201217153531000295756187 via GTWORLD  TO ZBN/AISHA NAMAMA ZUBAIRU ReF:GW681976569000000200002012171534,SAVINGS ACCOUNT,GT_Bank,./static/raw/MR_IBRAHIM_ASHAFA_STATEMENT.pdf,COMMISSION NIP TRANSFER COMMISSION FOR via GTWORLD TO ZBN AISHA NAMAMA ZUBAIRU ReF GW,COMMISSION NIP TRANSFER COMMISSION FOR via GTWORLD TO ZBN AISHA NAMAMA ZUBAIRU ReF GW,commission
17-Dec-2020,'0NIPG,17-Dec-2020,1.87,,"51,629.46",VALUE ADDED TAX 000013201217153531000295756187 VAT ON NIP TRANSFER FOR 000013201217153531000295756187 via GTWORLD  TO ZBN/AISHA NAMAMA ZUBAIRU ReF:GW681976569000000200002012171534,SAVINGS ACCOUNT,GT_Bank,./static/raw/MR_IBRAHIM_ASHAFA_STATEMENT.pdf,VALUE ADDED TAX VAT ON NIP TRANSFER FOR via GTWORLD TO ZBN AISHA NAMAMA ZUBAIRU ReF GW,VALUE ADDED TAX VAT ON NIP TRANSFER FOR via GTWORLD TO ZBN AISHA NAMAMA ZUBAIRU ReF GW,tax
17-Dec-2020,'0USAT,17-Dec-2020,800.00,,"50,829.46",Airtime Purchase GTWORLD_QL- 101CT0000000002225801734-2348038673032,SAVINGS ACCOUNT,GT_Bank,./static/raw/MR_IBRAHIM_ASHAFA_STATEMENT.pdf,Airtime Purchase GTWORLD_QL CT,Airtime Purchase GTWORLDQL CT,utility
17-Dec-2020,'0GWTR,17-Dec-2020,"28,000.00",,"22,829.46",TRANSFER BETWEEN CUSTOMERS Via GTWorld REF:681976569000000280002012172103  from ASHAFA IBRAHIM ABDULLAHI  to  ALIYU MUHAMMED AHMED,SAVINGS ACCOUNT,GT_Bank,./static/raw/MR_IBRAHIM_ASHAFA_STATEMENT.pdf,TRANSFER BETWEEN CUSTOMERS Via GTWorld REF from ASHAFA IBRAHIM ABDULLAHI to ALIYU MUHAMMED AHMED,TRANSFER BETWEEN CUSTOMERS Via GTWorld REF from ASHAFA IBRAHIM ABDULLAHI to ALIYU MUHAMMED AHMED,transfert
17-Dec-2020,'0,17-Dec-2020,50.00,,"22,779.46",STAMP DUTY CHARGE 17122020 STAMP DUTY CHARGE - 17/12/2020,SAVINGS ACCOUNT,GT_Bank,./static/raw/MR_IBRAHIM_ASHAFA_STATEMENT.pdf,STAMP DUTY CHARGE STAMP DUTY CHARGE,STAMP DUTY CHARGE STAMP DUTY CHARGE,bank_charges
18-Dec-2020,'0USAT,18-Dec-2020,500.00,,"22,279.46",Airtime Purchase GTWORLD_QL- 101CT0000000002226789521-2348038673032,SAVINGS ACCOUNT,GT_Bank,./static/raw/MR_IBRAHIM_ASHAFA_STATEMENT.pdf,Airtime Purchase GTWORLD_QL CT,Airtime Purchase GTWORLDQL CT,utility
18-Dec-2020,'99990129209999,18-Dec-2020,"12,000.00",,"10,279.46",POS/WEB PURCHASE TRANSACTION  -012920- - 520243-A.A RANO NIGERIA LIMITED            LANG,SAVINGS ACCOUNT,GT_Bank,./static/raw/MR_IBRAHIM_ASHAFA_STATEMENT.pdf,POS WEB PURCHASE TRANSACTION A A RANO NIGERIA LIMITED LANG,POS WEB PURCHASE TRANSACTIONA RANO NIGERIA LIMITED LANG,utility
20-Dec-2020,'99994451069999,20-Dec-2020,100.00,,"10,179.46",PURCHASE/TRANSFER COMMISSION  -445106- - 649649-WT|IBRAHIM SADANU ARIGU NNASSARAWA EG NG,SAVINGS ACCOUNT,GT_Bank,./static/raw/MR_IBRAHIM_ASHAFA_STATEMENT.pdf,PURCHASE TRANSFER COMMISSION WT IBRAHIM SADANU ARIGU NNASSARAWA EG NG,PURCHASE TRANSFER COMMISSION WT IBRAHIM SADANU ARIGU NNASSARAWA EG NG,transfert
20-Dec-2020,'99994451069999,20-Dec-2020,"10,000.00",,179.46,ATM/POS ACOUNT TO ACCOUNT TRANSFER  - 445106- -649649-WT|IBRAHIM SADANU ARIGU NNASSARAWA EG NG,SAVINGS ACCOUNT,GT_Bank,./static/raw/MR_IBRAHIM_ASHAFA_STATEMENT.pdf,ATM POS ACOUNT TO ACCOUNT TRANSFER WT IBRAHIM SADANU ARIGU NNASSARAWA EG NG,ATM POS ACOUNT TO ACCOUNT TRANSFER WT IBRAHIM SADANU ARIGU NNASSARAWA EG NG,transfert
20-Dec-2020,'00,20-Dec-2020,560.00,,-380.54,1% MANAGEMENT FEE AND 1% COMMITTMENT FEE GTWORLD Salary Advance Commission,SAVINGS ACCOUNT,GT_Bank,./static/raw/MR_IBRAHIM_ASHAFA_STATEMENT.pdf,MANAGEMENT FEE AND COMMITTMENT FEE GTWORLD Salary Advance Commission,MANAGEMENT FEE AND COMMITTMENT FEE GTWORLD Salary Advance Commission,utility
20-Dec-2020,'00,20-Dec-2020,42.00,,-422.54,VALUE ADDED TAX GTWORLD Salary Advance VAT,SAVINGS ACCOUNT,GT_Bank,./static/raw/MR_IBRAHIM_ASHAFA_STATEMENT.pdf,VALUE ADDED TAX GTWORLD Salary Advance VAT,VALUE ADDED TAX GTWORLD Salary Advance VAT,tax
20-Dec-2020,'0GWTR,20-Dec-2020.1,"7,000.00",,"-7,422.54","TRANSFER BETWEEN CUSTOMERS Via GTWorld REF:681976569000000070002012201553  from ASHAFA IBRAHIM ABDULLAHI  to  ABDULLATIF, RUKAYYA",SAVINGS ACCOUNT,GT_Bank,./static/raw/MR_IBRAHIM_ASHAFA_STATEMENT.pdf,TRANSFER BETWEEN CUSTOMERS Via GTWorld REF from ASHAFA IBRAHIM ABDULLAHI to ABDULLATIF RUKAYYA,TRANSFER BETWEEN CUSTOMERS Via GTWorld REF from ASHAFA IBRAHIM ABDULLAHI to ABDULLATIF RUKAYYA,transfert
20-Dec-2020,'0USAT,20-Dec-2020,400.00,,"-7,822.54",Airtime Purchase GTWORLD_QL- 101CT0000000002233859467-2348038673032,SAVINGS ACCOUNT,GT_Bank,./static/raw/MR_IBRAHIM_ASHAFA_STATEMENT.pdf,Airtime Purchase GTWORLD_QL CT,Airtime Purchase GTWORLDQL CT,utility
20-Dec-2020,'0GWTR,21-Dec-2020,"5,000.00",,"-12,822.54",TRANSFER BETWEEN CUSTOMERS Via GTWorld REF:681976569000000050002012202323  from ASHAFA IBRAHIM ABDULLAHI  to  ALIYU MUHAMMED AHMED,SAVINGS ACCOUNT,GT_Bank,./static/raw/MR_IBRAHIM_ASHAFA_STATEMENT.pdf,TRANSFER BETWEEN CUSTOMERS Via GTWorld REF from ASHAFA IBRAHIM ABDULLAHI to ALIYU MUHAMMED AHMED,TRANSFER BETWEEN CUSTOMERS Via GTWorld REF from ASHAFA IBRAHIM ABDULLAHI to ALIYU MUHAMMED AHMED,transfert
21-Dec-2020,'738430000,21-Dec-2020,"7,000.00",,"-19,822.54",POS/WEB PURCHASE TRANSACTION  -073843- - 723888-SHEMA PETROLEUM LIMI   KD KDNG,SAVINGS ACCOUNT,GT_Bank,./static/raw/MR_IBRAHIM_ASHAFA_STATEMENT.pdf,POS WEB PURCHASE TRANSACTION SHEMA PETROLEUM LIMI KD KDNG,POS WEB PURCHASE TRANSACTION SHEMA PETROLEUM LIMI KD KDNG,utility
22-Dec-2020,'0NIPG,22-Dec-2020,"3,000.00",,"-22,822.54",NIBSS Instant Payment Outward 000013201222102913000303067891 via GTWORLD  TO UBA/YAKUBU ASHAFA ABDULLAHI /10.75/REF:GW6819765690000000300020122210  f,SAVINGS ACCOUNT,GT_Bank,./static/raw/MR_IBRAHIM_ASHAFA_STATEMENT.pdf,NIBSS Instant Payment Outward via GTWORLD TO UBA YAKUBU ASHAFA ABDULLAHI REF GW f,NIBSS Instant Payment Outward via GTWORLD TO UBA YAKUBU ASHAFA ABDULLAHI REF GW,transfert
22-Dec-2020,'0NIPG,22-Dec-2020,10.00,,"-22,832.54",COMMISSION 000013201222102913000303067891 NIP TRANSFER COMMISSION FOR 000013201222102913000303067891 via GTWORLD  TO UBA/YAKUBU ASHAFA ABDULLAHI ReF:GW681976569000000030002012221028,SAVINGS ACCOUNT,GT_Bank,./static/raw/MR_IBRAHIM_ASHAFA_STATEMENT.pdf,COMMISSION NIP TRANSFER COMMISSION FOR via GTWORLD TO UBA YAKUBU ASHAFA ABDULLAHI ReF GW,COMMISSION NIP TRANSFER COMMISSION FOR via GTWORLD TO UBA YAKUBU ASHAFA ABDULLAHI ReF GW,commission
22-Dec-2020,'0NIPG,22-Dec-2020,.75,,"-22,833.29",VALUE ADDED TAX 000013201222102913000303067891 VAT ON NIP TRANSFER FOR 000013201222102913000303067891 via GTWORLD  TO UBA/YAKUBU ASHAFA ABDULLAHI ReF:GW681976569000000030002012221028,SAVINGS ACCOUNT,GT_Bank,./static/raw/MR_IBRAHIM_ASHAFA_STATEMENT.pdf,VALUE ADDED TAX VAT ON NIP TRANSFER FOR via GTWORLD TO UBA YAKUBU ASHAFA ABDULLAHI ReF GW,VALUE ADDED TAX VAT ON NIP TRANSFER FOR via GTWORLD TO UBA YAKUBU ASHAFA ABDULLAHI ReF GW,tax
22-Dec-2020,'0NIPG,22-Dec-2020,"1,000.00",,"-23,833.29",NIBSS Instant Payment Outward 000013201222122228000303286132 via GTWORLD  TO ACCESS/GRACE EHI AYEGBA KING /10.75/REF:GW6819765690000000100020122212  f,SAVINGS ACCOUNT,GT_Bank,./static/raw/MR_IBRAHIM_ASHAFA_STATEMENT.pdf,NIBSS Instant Payment Outward via GTWORLD TO ACCESS GRACE EHI AYEGBA KING REF GW f,NIBSS Instant Payment Outward via GTWORLD TO ACCESS GRACE EHI AYEGBA KING REF GW,transfert
22-Dec-2020,'0NIPG,22-Dec-2020,10.00,,"-23,843.29",COMMISSION 000013201222122228000303286132 NIP TRANSFER COMMISSION FOR000013201222122228000303286132 viaGTWORLD  TO ACCESS/GRACE EHI AYEGBAKINGReF:GW681976569000000010002012221221,SAVINGS ACCOUNT,GT_Bank,./static/raw/MR_IBRAHIM_ASHAFA_STATEMENT.pdf,COMMISSION NIP TRANSFER COMMISSION FOR viaGTWORLD TO ACCESS GRACE EHI AYEGBAKINGReF GW,COMMISSION NIP TRANSFER COMMISSION FOR via GTWORLD TO ACCESS GRACE EHI AYEGBAKINGReF GW,commission
22-Dec-2020,'0NIPG,22-Dec-2020,.75,,"-23,844.04",VALUE ADDED TAX000013201222122228000303286132 VAT ON NIPTRANSFER FOR000013201222122228000303286132 viaGTWORLD  TO ACCESS/GRACE EHI AYEGBAKINGReF:GW681976569000000010002012221221,SAVINGS ACCOUNT,GT_Bank,./static/raw/MR_IBRAHIM_ASHAFA_STATEMENT.pdf,VALUE ADDED TAX VAT ON NIPTRANSFER FOR viaGTWORLD TO ACCESS GRACE EHI AYEGBAKINGReF GW,VALUE ADDED TAX VAT ON NIPTRANSFER FOR via GTWORLD TO ACCESS GRACE EHI AYEGBAKINGReF GW,tax
22-Dec-2020,'99994726499999,22-Dec-2020,"2,000.00",,"-25,844.04",CASH WITHDRAWAL FROM OTHER ATM  -472649- -980549-000000000000068 Abuja  AbujaNG,SAVINGS ACCOUNT,GT_Bank,./static/raw/MR_IBRAHIM_ASHAFA_STATEMENT.pdf,CASH WITHDRAWAL FROM OTHER ATM Abuja AbujaNG,CASH WITHDRAWAL FROM OTHER ATM Abuja AbujaNG,cash
22-Dec-2020,'99994769279999,22-Dec-2020,35.00,,"-25,879.04",ATM WITHDRAWAL COMMISSION  -476927- -982668-000000000000068 Abuja  AbujaNG,SAVINGS ACCOUNT,GT_Bank,./static/raw/MR_IBRAHIM_ASHAFA_STATEMENT.pdf,ATM WITHDRAWAL COMMISSION Abuja AbujaNG,ATM WITHDRAWAL COMMISSION Abuja AbujaNG,utility
22-Dec-2020,'99994769279999,22-Dec-2020,"2,000.00",,"-27,879.04",CASH WITHDRAWAL FROM OTHER ATM  -476927- -982668-000000000000068 Abuja  AbujaNG,SAVINGS ACCOUNT,GT_Bank,./static/raw/MR_IBRAHIM_ASHAFA_STATEMENT.pdf,CASH WITHDRAWAL FROM OTHER ATM Abuja AbujaNG,CASH WITHDRAWAL FROM OTHER ATM Abuja AbujaNG,cash
22-Dec-2020,'0NIPT,22-Dec-2020,,"20,000.00","-7,879.04",TRANSFER BETWEEN CUSTOMERS000004201222163238000920751317|MB/UTO/920751317/2348036484648/Trf to0131934493|2348036484648/920751317||MUSA TUSMANREF:000004201222163238000920751317,SAVINGS ACCOUNT,GT_Bank,./static/raw/MR_IBRAHIM_ASHAFA_STATEMENT.pdf,TRANSFER BETWEEN CUSTOMERS MB UTO Trf to MUSA TUSMANREF,TRANSFER BETWEEN CUSTOMERS MB UTO Trf to MUSA TUSMANREF,transfert
22-Dec-2020,'0GWTR,22-Dec-2020,"10,000.00",,"-17,879.04",TRANSFER BETWEEN CUSTOMERS Via GTWorldREF:681976569000000100002012221722  fromASHAFA IBRAHIM ABDULLAHI  to  ALIYUMUHAMMED AHMED,SAVINGS ACCOUNT,GT_Bank,./static/raw/MR_IBRAHIM_ASHAFA_STATEMENT.pdf,TRANSFER BETWEEN CUSTOMERS Via GTWorldREF fromASHAFA IBRAHIM ABDULLAHI to ALIYUMUHAMMED AHMED,TRANSFER BETWEEN CUSTOMERS Via GTWorldREF from ASHAFA IBRAHIM ABDULLAHI to ALIYUMUHAMMED AHMED,transfert
22-Dec-2020,'0NIPT,22-Dec-2020,,"20,000.00","2,120.96",TRANSFER BETWEEN CUSTOMERS000004201222173359000920864433|MB/UTO/920864433/2348036484648/Trf to0131934493|2348036484648/920864433||MUSA TUSMANREF:000004201222173359000920864433,SAVINGS ACCOUNT,GT_Bank,./static/raw/MR_IBRAHIM_ASHAFA_STATEMENT.pdf,TRANSFER BETWEEN CUSTOMERS MB UTO Trf to MUSA TUSMANREF,TRANSFER BETWEEN CUSTOMERS MB UTO Trf to MUSA TUSMANREF,transfert
22-Dec-2020,'0NIPG,22-Dec-2020,"10,000.00",,"-7,879.04",NIBSS Instant Payment Outward000013201222192239000304207684 viaGTWORLD  TO FCMB/ADAM HAFSATMOHAMMED /26.875/REF:GW6819765690000001000020122219 f,SAVINGS ACCOUNT,GT_Bank,./static/raw/MR_IBRAHIM_ASHAFA_STATEMENT.pdf,NIBSS Instant Payment Outward viaGTWORLD TO FCMB ADAM HAFSATMOHAMMED REF GW f,NIBSS Instant Payment Outward via GTWORLD TO FCMB ADAM HAFSATMOHAMMED REF GW,transfert
22-Dec-2020,'0NIPG,22-Dec-2020,25.00,,"-7,904.04",COMMISSION 000013201222192239000304207684 NIP TRANSFER COMMISSION FOR 000013201222192239000304207684 via GTWORLD  TO FCMB/ADAM HAFSAT MOHAMMED ReF:GW681976569000000100002012221921,SAVINGS ACCOUNT,GT_Bank,./static/raw/MR_IBRAHIM_ASHAFA_STATEMENT.pdf,COMMISSION NIP TRANSFER COMMISSION FOR via GTWORLD TO FCMB ADAM HAFSAT MOHAMMED ReF GW,COMMISSION NIP TRANSFER COMMISSION FOR via GTWORLD TO FCMB ADAM HAFSAT MOHAMMED ReF GW,commission
22-Dec-2020,'0NIPG,22-Dec-2020,1.87,,"-7,905.91",VALUE ADDED TAX 000013201222192239000304207684 VAT ON NIP TRANSFER FOR 000013201222192239000304207684 via GTWORLD  TO FCMB/ADAM HAFSAT MOHAMMED ReF:GW681976569000000100002012221921,SAVINGS ACCOUNT,GT_Bank,./static/raw/MR_IBRAHIM_ASHAFA_STATEMENT.pdf,VALUE ADDED TAX VAT ON NIP TRANSFER FOR via GTWORLD TO FCMB ADAM HAFSAT MOHAMMED ReF GW,VALUE ADDED TAX VAT ON NIP TRANSFER FOR via GTWORLD TO FCMB ADAM HAFSAT MOHAMMED ReF GW,tax
22-Dec-2020,'0GWTR,22-Dec-2020,"10,000.00",,"-17,905.91",TRANSFER BETWEEN CUSTOMERS Via GTWorld REF:681976569000000100002012221923  from ASHAFA IBRAHIM ABDULLAHI  to  ALIYU MUHAMMED AHMED,SAVINGS ACCOUNT,GT_Bank,./static/raw/MR_IBRAHIM_ASHAFA_STATEMENT.pdf,TRANSFER BETWEEN CUSTOMERS Via GTWorld REF from ASHAFA IBRAHIM ABDULLAHI to ALIYU MUHAMMED AHMED,TRANSFER BETWEEN CUSTOMERS Via GTWorld REF from ASHAFA IBRAHIM ABDULLAHI to ALIYU MUHAMMED AHMED,transfert
22-Dec-2020,'0USAT,22-Dec-2020,500.00,,"-18,405.91",Airtime Purchase GTWORLD- 101CT0000000002239207925-2348030549818,SAVINGS ACCOUNT,GT_Bank,./static/raw/MR_IBRAHIM_ASHAFA_STATEMENT.pdf,Airtime Purchase GTWORLD CT,Airtime Purchase GTWORLD CT,utility
22-Dec-2020,'0USAT,22-Dec-2020,400.00,,"-18,805.91",Airtime Purchase GTWORLD- 101CT0000000002239209400-2348038673032,SAVINGS ACCOUNT,GT_Bank,./static/raw/MR_IBRAHIM_ASHAFA_STATEMENT.pdf,Airtime Purchase GTWORLD CT,Airtime Purchase GTWORLD CT,utility
22-Dec-2020,'0NIPU,22-Dec-2020,"3,500.00",,"-22,305.91",NIBSS Instant Payment Outward 000013201222200757000304284975 USSD NIP Transfer from  08038673032  TO UBA/YAKUBU ASHAFA ABDULLAHI /10.75/REF:000013201222200757000304284975,SAVINGS ACCOUNT,GT_Bank,./static/raw/MR_IBRAHIM_ASHAFA_STATEMENT.pdf,NIBSS Instant Payment Outward USSD NIP Transfer from TO UBA YAKUBU ASHAFA ABDULLAHI REF,NIBSS Instant Payment Outward USSD NIP Transfer from TO UBA YAKUBU ASHAFA ABDULLAHI REF,transfert
22-Dec-2020,'0NIPU,22-Dec-2020,10.00,,"-22,315.91",COMMISSION 000013201222200757000304284975 USSD NIP RECOVERY CHARGE ReF:000013201222200757000304284975,SAVINGS ACCOUNT,GT_Bank,./static/raw/MR_IBRAHIM_ASHAFA_STATEMENT.pdf,COMMISSION USSD NIP RECOVERY CHARGE ReF,COMMISSION USSD NIP RECOVERY CHARGE ReF,transfert
22-Dec-2020,'0NIPU,22-Dec-2020,.75,,"-22,316.66",VALUE ADDED TAX 000013201222200757000304284975 VAT ON USSD NIP RECOVERY CHARGE ReF:000013201222200757000304284975,SAVINGS ACCOUNT,GT_Bank,./static/raw/MR_IBRAHIM_ASHAFA_STATEMENT.pdf,VALUE ADDED TAX VAT ON USSD NIP RECOVERY CHARGE ReF,VALUE ADDED TAX VAT ON USSD NIP RECOVERY CHARGE ReF,tax
22-Dec-2020,'0,22-Dec-2020,100.00,,"-22,416.66",STAMP DUTY CHARGE 22122020 STAMP DUTY CHARGE - 22/12/2020,SAVINGS ACCOUNT,GT_Bank,./static/raw/MR_IBRAHIM_ASHAFA_STATEMENT.pdf,STAMP DUTY CHARGE STAMP DUTY CHARGE,STAMP DUTY CHARGE STAMP DUTY CHARGE,bank_charges
23-Dec-2020,'99993389179999,23-Dec-2020.1,"2,100.00",,"-24,516.66",POS/WEB PURCHASE TRANSACTION  -338917- - 708511-PAYCOM NIGERIA LIMIT   LA           LANG,SAVINGS ACCOUNT,GT_Bank,./static/raw/MR_IBRAHIM_ASHAFA_STATEMENT.pdf,POS WEB PURCHASE TRANSACTION PAYCOM NIGERIA LIMIT LA LANG,POS WEB PURCHASE TRANSACTION PAYCOM NIGERIA LIMIT LA LANG,utility
23-Dec-2020,'0USAT,23-Dec-2020,300.00,,"-24,816.66",Airtime Purchase GTWORLD_QL- 101CT0000000002240614186-2348038673032,SAVINGS ACCOUNT,GT_Bank,./static/raw/MR_IBRAHIM_ASHAFA_STATEMENT.pdf,Airtime Purchase GTWORLD_QL CT,Airtime Purchase GTWORLDQL CT,utility
24-Dec-2020,'0GAPS,24-Dec-2020,,"71,250.00","46,433.34",TRANSFER BETWEEN CUSTOMERS via GAPS com on Fatima Mutiu 3M sales 105453025 0 from NETCONSTRUCT NIGERIA LIMITED to ASHAFA IBRAHIM ABDULLAHI REF: 0005628626105453025000000,SAVINGS ACCOUNT,GT_Bank,./static/raw/MR_IBRAHIM_ASHAFA_STATEMENT.pdf,TRANSFER BETWEEN CUSTOMERS via GAPS com on Fatima Mutiu M sales from NETCONSTRUCT NIGERIA LIMITED to ASHAFA IBRAHIM ABDULLAHI REF,TRANSFER BETWEEN CUSTOMERS via GAPS com on Fatima Mutiusales from NETCONSTRUCT NIGERIA LIMITED to ASHAFA IBRAHIM ABDULLAHI REF,transfert
24-Dec-2020,'0GAPS,24-Dec-2020,,"57,000.00","103,433.34",TRANSFER BETWEEN CUSTOMERS via GAPS com on Ibiye n Piriye 4M sales 105453026 0 from NETCONSTRUCT NIGERIA LIMITED to ASHAFA IBRAHIM ABDULLAHI REF: 0005628626105453026000000,SAVINGS ACCOUNT,GT_Bank,./static/raw/MR_IBRAHIM_ASHAFA_STATEMENT.pdf,TRANSFER BETWEEN CUSTOMERS via GAPS com on Ibiye n Piriye M sales from NETCONSTRUCT NIGERIA LIMITED to ASHAFA IBRAHIM ABDULLAHI REF,TRANSFER BETWEEN CUSTOMERS via GAPS com on IbiyePiriyesales from NETCONSTRUCT NIGERIA LIMITED to ASHAFA IBRAHIM ABDULLAHI REF,transfert
24-Dec-2020,'0GAPS,24-Dec-2020,,"95,000.00","198,433.34",TRANSFER BETWEEN CUSTOMERS via GAPS com on Kenneth J 4M sales 105453027 0 from NETCONSTRUCT NIGERIA LIMITED to ASHAFA IBRAHIM ABDULLAHI REF: 0005628626105453027000000,SAVINGS ACCOUNT,GT_Bank,./static/raw/MR_IBRAHIM_ASHAFA_STATEMENT.pdf,TRANSFER BETWEEN CUSTOMERS via GAPS com on Kenneth J M sales from NETCONSTRUCT NIGERIA LIMITED to ASHAFA IBRAHIM ABDULLAHI REF,TRANSFER BETWEEN CUSTOMERS via GAPS com on KennethM sales from NETCONSTRUCT NIGERIA LIMITED to ASHAFA IBRAHIM ABDULLAHI REF,transfert
24-Dec-2020,'99990435319999,24-Dec-2020,35.00,,"198,398.34",ATM WITHDRAWAL COMMISSION  -043531- - 004370-EBN000000005631 ENG NS NS             NG,SAVINGS ACCOUNT,GT_Bank,./static/raw/MR_IBRAHIM_ASHAFA_STATEMENT.pdf,ATM WITHDRAWAL COMMISSION EBN ENG NS NS NG,ATM WITHDRAWAL COMMISSION EBN ENG NS NS NG,utility
24-Dec-2020,'99990435319999,24-Dec-2020,"10,000.00",,"188,398.34",CASH WITHDRAWAL FROM OTHER ATM  - 043531- -004370-EBN000000005631 ENG NS NS NG,SAVINGS ACCOUNT,GT_Bank,./static/raw/MR_IBRAHIM_ASHAFA_STATEMENT.pdf,CASH WITHDRAWAL FROM OTHER ATM EBN ENG NS NS NG,CASH WITHDRAWAL FROM OTHER ATM EBN ENG NS NS NG,cash
24-Dec-2020,'99990539129999,24-Dec-2020,35.00,,"188,363.34",ATM WITHDRAWAL COMMISSION  -053912- - 007721-EBN000000005631 ENG NS NS             NG,SAVINGS ACCOUNT,GT_Bank,./static/raw/MR_IBRAHIM_ASHAFA_STATEMENT.pdf,ATM WITHDRAWAL COMMISSION EBN ENG NS NS NG,ATM WITHDRAWAL COMMISSION EBN ENG NS NS NG,utility
24-Dec-2020,'99990539129999,24-Dec-2020,"10,000.00",,"178,363.34",CASH WITHDRAWAL FROM OTHER ATM  - 053912- -007721-EBN000000005631 ENG NS NS NG,SAVINGS ACCOUNT,GT_Bank,./static/raw/MR_IBRAHIM_ASHAFA_STATEMENT.pdf,CASH WITHDRAWAL FROM OTHER ATM EBN ENG NS NS NG,CASH WITHDRAWAL FROM OTHER ATM EBN ENG NS NS NG,cash
24-Dec-2020,'99990622529999,24-Dec-2020,35.00,,"178,328.34",ATM WITHDRAWAL COMMISSION  -062252- - 010374-EBN000000005631 ENG NS NS             NG,SAVINGS ACCOUNT,GT_Bank,./static/raw/MR_IBRAHIM_ASHAFA_STATEMENT.pdf,ATM WITHDRAWAL COMMISSION EBN ENG NS NS NG,ATM WITHDRAWAL COMMISSION EBN ENG NS NS NG,utility
24-Dec-2020,'99990622529999,24-Dec-2020,"10,000.00",,"168,328.34",CASH WITHDRAWAL FROM OTHER ATM  - 062252- -010374-EBN000000005631 ENG NS NS NG,SAVINGS ACCOUNT,GT_Bank,./static/raw/MR_IBRAHIM_ASHAFA_STATEMENT.pdf,CASH WITHDRAWAL FROM OTHER ATM EBN ENG NS NS NG,CASH WITHDRAWAL FROM OTHER ATM EBN ENG NS NS NG,cash
24-Dec-2020,'0GWTR,24-Dec-2020,"26,000.00",,"142,328.34",TRANSFER BETWEEN CUSTOMERS Via GTWorld REF:681976569000000260002012241601  from ASHAFA IBRAHIM ABDULLAHI  to  MUHAMMADISMAIL RABO,SAVINGS ACCOUNT,GT_Bank,./static/raw/MR_IBRAHIM_ASHAFA_STATEMENT.pdf,TRANSFER BETWEEN CUSTOMERS Via GTWorld REF from ASHAFA IBRAHIM ABDULLAHI to MUHAMMADISMAIL RABO,TRANSFER BETWEEN CUSTOMERS Via GTWorld REF from ASHAFA IBRAHIM ABDULLAHI to MUHAMMADISMAIL RABO,transfert
24-Dec-2020,'0GWTR,24-Dec-2020,"60,000.00",,"82,328.34","TRANSFER BETWEEN CUSTOMERS Via GTWorld REF:681976569000000600002012241605  from ASHAFA IBRAHIM ABDULLAHI  to  MUNDU HAUWA, MOHAMMED",SAVINGS ACCOUNT,GT_Bank,./static/raw/MR_IBRAHIM_ASHAFA_STATEMENT.pdf,TRANSFER BETWEEN CUSTOMERS Via GTWorld REF from ASHAFA IBRAHIM ABDULLAHI to MUNDU HAUWA MOHAMMED,TRANSFER BETWEEN CUSTOMERS Via GTWorld REF from ASHAFA IBRAHIM ABDULLAHI to MUNDU HAUWA MOHAMMED,transfert
24-Dec-2020,'0GWTR,24-Dec-2020,"12,000.00",,"70,328.34",TRANSFER BETWEEN CUSTOMERS Via GTWorld REF:681976569000000120002012241618  from ASHAFA IBRAHIM ABDULLAHI  to  ALIYU MUHAMMED AHMED,SAVINGS ACCOUNT,GT_Bank,./static/raw/MR_IBRAHIM_ASHAFA_STATEMENT.pdf,TRANSFER BETWEEN CUSTOMERS Via GTWorld REF from ASHAFA IBRAHIM ABDULLAHI to ALIYU MUHAMMED AHMED,TRANSFER BETWEEN CUSTOMERS Via GTWorld REF from ASHAFA IBRAHIM ABDULLAHI to ALIYU MUHAMMED AHMED,transfert
24-Dec-2020,'0NIPG,24-Dec-2020,"10,000.00",,"60,328.34",NIBSS Instant Payment Outward 000013201224162552000307572652 via GTWORLD  TO UNITY/ABUBAKAR ABDULRAKIB /26.875/REF:GW6819765690000001000020122416 f,SAVINGS ACCOUNT,GT_Bank,./static/raw/MR_IBRAHIM_ASHAFA_STATEMENT.pdf,NIBSS Instant Payment Outward via GTWORLD TO UNITY ABUBAKAR ABDULRAKIB REF GW f,NIBSS Instant Payment Outward via GTWORLD TO UNITY ABUBAKAR ABDULRAKIB REF GW,transfert
24-Dec-2020,'0NIPG,24-Dec-2020,25.00,,"60,303.34",COMMISSION 000013201224162552000307572652 NIP TRANSFER COMMISSION FOR 000013201224162552000307572652 via GTWORLD  TO UNITY/ABUBAKAR ABDULRAKIB ReF:GW681976569000000100002012241623,SAVINGS ACCOUNT,GT_Bank,./static/raw/MR_IBRAHIM_ASHAFA_STATEMENT.pdf,COMMISSION NIP TRANSFER COMMISSION FOR via GTWORLD TO UNITY ABUBAKAR ABDULRAKIB ReF GW,COMMISSION NIP TRANSFER COMMISSION FOR via GTWORLD TO UNITY ABUBAKAR ABDULRAKIB ReF GW,commission
24-Dec-2020,'0NIPG,24-Dec-2020,1.87,,"60,301.47",VALUE ADDED TAX 000013201224162552000307572652 VAT ON NIP TRANSFER FOR 000013201224162552000307572652 via GTWORLD  TO UNITY/ABUBAKAR ABDULRAKIB ReF:GW681976569000000100002012241623,SAVINGS ACCOUNT,GT_Bank,./static/raw/MR_IBRAHIM_ASHAFA_STATEMENT.pdf,VALUE ADDED TAX VAT ON NIP TRANSFER FOR via GTWORLD TO UNITY ABUBAKAR ABDULRAKIB ReF GW,VALUE ADDED TAX VAT ON NIP TRANSFER FOR via GTWORLD TO UNITY ABUBAKAR ABDULRAKIB ReF GW,tax
24-Dec-2020,'0USAT,24-Dec-2020,"1,000.00",,"59,301.47",Airtime Purchase GTWORLD- 101CT0000000002244355978-2348038673032,SAVINGS ACCOUNT,GT_Bank,./static/raw/MR_IBRAHIM_ASHAFA_STATEMENT.pdf,Airtime Purchase GTWORLD CT,Airtime Purchase GTWORLD CT,utility
24-Dec-2020,'0,24-Dec-2020,150.00,,"59,151.47",STAMP DUTY CHARGE 24122020 STAMP DUTY CHARGE - 24/12/2020,SAVINGS ACCOUNT,GT_Bank,./static/raw/MR_IBRAHIM_ASHAFA_STATEMENT.pdf,STAMP DUTY CHARGE STAMP DUTY CHARGE,STAMP DUTY CHARGE STAMP DUTY CHARGE,bank_charges
25-Dec-2020,'99990538039999,25-Dec-2020,"10,200.00",,"48,951.47",POS/WEB PURCHASE TRANSACTION  -053803- - 520446-ECOSYSTEM ACCELEREX    LA LANG,SAVINGS ACCOUNT,GT_Bank,./static/raw/MR_IBRAHIM_ASHAFA_STATEMENT.pdf,POS WEB PURCHASE TRANSACTION ECOSYSTEM ACCELEREX LA LANG,POS WEB PURCHASE TRANSACTION ECOSYSTEM ACCELEREX LA LANG,utility
25-Dec-2020,'0GWTR,25-Dec-2020,"5,000.00",,"43,951.47","TRANSFER BETWEEN CUSTOMERS Via GTWorld REF:681976569000000050002012251657  from ASHAFA IBRAHIM ABDULLAHI  to  MUHAMMAD, IBRAHIM",SAVINGS ACCOUNT,GT_Bank,./static/raw/MR_IBRAHIM_ASHAFA_STATEMENT.pdf,TRANSFER BETWEEN CUSTOMERS Via GTWorld REF from ASHAFA IBRAHIM ABDULLAHI to MUHAMMAD IBRAHIM,TRANSFER BETWEEN CUSTOMERS Via GTWorld REF from ASHAFA IBRAHIM ABDULLAHI to MUHAMMAD IBRAHIM,transfert
26-Dec-2020,'160,25-Dec-2020,376.00,,"43,575.47",SMS ALERT CHARGE FOR 25NOV2020-20DEC2020,SAVINGS ACCOUNT,GT_Bank,./static/raw/MR_IBRAHIM_ASHAFA_STATEMENT.pdf,SMS ALERT CHARGE FOR NOV DEC,SMS ALERT CHARGE FOR NOV DEC,loan
26-Dec-2020,'170,25-Dec-2020,28.20,,"43,547.27",VAT ON SMS ALERT CHARGE FOR 25NOV2020- 20DEC2020,SAVINGS ACCOUNT,GT_Bank,./static/raw/MR_IBRAHIM_ASHAFA_STATEMENT.pdf,VAT ON SMS ALERT CHARGE FOR NOV DEC,VAT ON SMS ALERT CHARGE FOR NOV DEC,tax
26-Dec-2020,'0USAT,26-Dec-2020,500.00,,"43,047.27",Airtime Purchase GTWORLD_QL- 101CT0000000002248852690-2348038673032,SAVINGS ACCOUNT,GT_Bank,./static/raw/MR_IBRAHIM_ASHAFA_STATEMENT.pdf,Airtime Purchase GTWORLD_QL CT,Airtime Purchase GTWORLDQL CT,utility
26-Dec-2020,'0NIPG,26-Dec-2020,"15,000.00",,"28,047.27",NIBSS Instant Payment Outward 000013201226155837000310546930 via GTWORLD  TO UBA/ALIYU HAUWA /26.875/REF:GW6819765690000001500020122615 f,SAVINGS ACCOUNT,GT_Bank,./static/raw/MR_IBRAHIM_ASHAFA_STATEMENT.pdf,NIBSS Instant Payment Outward via GTWORLD TO UBA ALIYU HAUWA REF GW f,NIBSS Instant Payment Outward via GTWORLD TO UBA ALIYU HAUWA REF GW,transfert
26-Dec-2020,'0NIPG,26-Dec-2020,25.00,,"28,022.27",COMMISSION 000013201226155837000310546930 NIP TRANSFER COMMISSION FOR 000013201226155837000310546930 via GTWORLD  TO UBA/ALIYU HAUWA ReF:GW681976569000000150002012261557,SAVINGS ACCOUNT,GT_Bank,./static/raw/MR_IBRAHIM_ASHAFA_STATEMENT.pdf,COMMISSION NIP TRANSFER COMMISSION FOR via GTWORLD TO UBA ALIYU HAUWA ReF GW,COMMISSION NIP TRANSFER COMMISSION FOR via GTWORLD TO UBA ALIYU HAUWA ReF GW,commission
26-Dec-2020,'0NIPG,26-Dec-2020,1.87,,"28,020.40",VALUE ADDED TAX 000013201226155837000310546930 VAT ON NIP TRANSFER FOR 000013201226155837000310546930 via GTWORLD  TO UBA/ALIYU HAUWA ReF:GW681976569000000150002012261557,SAVINGS ACCOUNT,GT_Bank,./static/raw/MR_IBRAHIM_ASHAFA_STATEMENT.pdf,VALUE ADDED TAX VAT ON NIP TRANSFER FOR via GTWORLD TO UBA ALIYU HAUWA ReF GW,VALUE ADDED TAX VAT ON NIP TRANSFER FOR via GTWORLD TO UBA ALIYU HAUWA ReF GW,tax
26-Dec-2020,'0NIPG,26-Dec-2020,"10,000.00",,"18,020.40",NIBSS Instant Payment Outward 000013201226183156000310764715 via GTWORLD  TO FBN/DEMIDE ENEYAMIRE JEMILATU /26.875/REF:GW6819765690000001000020122618 f,SAVINGS ACCOUNT,GT_Bank,./static/raw/MR_IBRAHIM_ASHAFA_STATEMENT.pdf,NIBSS Instant Payment Outward via GTWORLD TO FBN DEMIDE ENEYAMIRE JEMILATU REF GW f,NIBSS Instant Payment Outward via GTWORLD TO FBN DEMIDE ENEYAMIRE JEMILATU REF GW,transfert
26-Dec-2020,'0NIPG,26-Dec-2020,25.00,,"17,995.40",COMMISSION 000013201226183156000310764715 NIP TRANSFER COMMISSION FOR 000013201226183156000310764715 via GTWORLD  TO FBN/DEMIDE ENEYAMIRE JEMILATU ReF:GW681976569000000100002012261830,SAVINGS ACCOUNT,GT_Bank,./static/raw/MR_IBRAHIM_ASHAFA_STATEMENT.pdf,COMMISSION NIP TRANSFER COMMISSION FOR via GTWORLD TO FBN DEMIDE ENEYAMIRE JEMILATU ReF GW,COMMISSION NIP TRANSFER COMMISSION FOR via GTWORLD TO FBN DEMIDE ENEYAMIRE JEMILATU ReF GW,commission
26-Dec-2020,'0NIPG,26-Dec-2020,1.87,,"17,993.53",VALUE ADDED TAX 000013201226183156000310764715 VAT ON NIP TRANSFER FOR 000013201226183156000310764715 via GTWORLD  TO FBN/DEMIDE ENEYAMIREJEMILATUReF:GW681976569000000100002012261830,SAVINGS ACCOUNT,GT_Bank,./static/raw/MR_IBRAHIM_ASHAFA_STATEMENT.pdf,VALUE ADDED TAX VAT ON NIP TRANSFER FOR via GTWORLD TO FBN DEMIDE ENEYAMIREJEMILATUReF GW,VALUE ADDED TAX VAT ON NIP TRANSFER FOR via GTWORLD TO FBN DEMIDE ENEYAMIREJEMILATUReF GW,tax
26-Dec-2020,'0NIPU,26-Dec-2020,"11,000.00",,"6,993.53",NIBSS Instant Payment Outward000013201226205904000310937096 USSD NIPTransfer from  08038673032  TO UBA/YAKUBUASHAFA ABDULLAHI/26.875/REF:000013201226205904000310937096,SAVINGS ACCOUNT,GT_Bank,./static/raw/MR_IBRAHIM_ASHAFA_STATEMENT.pdf,NIBSS Instant Payment Outward USSD NIPTransfer from TO UBA YAKUBUASHAFA ABDULLAHI REF,NIBSS Instant Payment Outward USSD NIPTransfer from TO UBA YAKUBUASHAFA ABDULLAHI REF,transfert
26-Dec-2020,'0NIPU,26-Dec-2020,25.00,,"6,968.53",COMMISSION 000013201226205904000310937096USSD NIP RECOVERY CHARGEReF:000013201226205904000310937096,SAVINGS ACCOUNT,GT_Bank,./static/raw/MR_IBRAHIM_ASHAFA_STATEMENT.pdf,COMMISSION USSD NIP RECOVERY CHARGEReF,COMMISSION USSD NIP RECOVERY CHARGEReF,transfert
26-Dec-2020,'0NIPU,26-Dec-2020,1.87,,"6,966.66",VALUE ADDED TAX000013201226205904000310937096 VAT ONUSSD NIP RECOVERY CHARGEReF:000013201226205904000310937096,SAVINGS ACCOUNT,GT_Bank,./static/raw/MR_IBRAHIM_ASHAFA_STATEMENT.pdf,VALUE ADDED TAX VAT ONUSSD NIP RECOVERY CHARGEReF,VALUE ADDED TAX VAT ONUSSD NIP RECOVERY CHARGEReF,tax
26-Dec-2020,'0USAT,26-Dec-2020,400.00,,"6,566.66",Airtime Purchase GTWORLD_QL-101CT0000000002249799175-2348030549818,SAVINGS ACCOUNT,GT_Bank,./static/raw/MR_IBRAHIM_ASHAFA_STATEMENT.pdf,Airtime Purchase GTWORLD_QL CT,Airtime Purchase GTWORLDQL CT,utility
26-Dec-2020,'0USAT,26-Dec-2020,400.00,,"6,166.66",Airtime Purchase GTWORLD_QL-101CT0000000002249799978-2348038673032,SAVINGS ACCOUNT,GT_Bank,./static/raw/MR_IBRAHIM_ASHAFA_STATEMENT.pdf,Airtime Purchase GTWORLD_QL CT,Airtime Purchase GTWORLDQL CT,utility
27-Dec-2020,'0NIPG,27-Dec-2020,"1,500.00",,"4,666.66",NIBSS Instant Payment Outward000013201227114013000311348173 viaGTWORLD  TO FCMB/HUSAINI AMINU/10.75/REF:GW6819765690000000150020122711  f,SAVINGS ACCOUNT,GT_Bank,./static/raw/MR_IBRAHIM_ASHAFA_STATEMENT.pdf,NIBSS Instant Payment Outward viaGTWORLD TO FCMB HUSAINI AMINU REF GW f,NIBSS Instant Payment Outward via GTWORLD TO FCMB HUSAINI AMINU REF GW,transfert
27-Dec-2020,'0NIPG,27-Dec-2020,10.00,,"4,656.66",COMMISSION 000013201227114013000311348173NIP TRANSFER COMMISSION FOR000013201227114013000311348173 viaGTWORLD  TO FCMB/HUSAINI AMINUReF:GW681976569000000015002012271138,SAVINGS ACCOUNT,GT_Bank,./static/raw/MR_IBRAHIM_ASHAFA_STATEMENT.pdf,COMMISSION NIP TRANSFER COMMISSION FOR viaGTWORLD TO FCMB HUSAINI AMINUReF GW,COMMISSION NIP TRANSFER COMMISSION FOR via GTWORLD TO FCMB HUSAINI AMINUReF GW,commission
27-Dec-2020,'0NIPG,27-Dec-2020,.75,,"4,655.91",VALUE ADDED TAX000013201227114013000311348173 VAT ON NIPTRANSFER FOR000013201227114013000311348173 viaGTWORLD  TO FCMB/HUSAINI AMINUReF:GW681976569000000015002012271138,SAVINGS ACCOUNT,GT_Bank,./static/raw/MR_IBRAHIM_ASHAFA_STATEMENT.pdf,VALUE ADDED TAX VAT ON NIPTRANSFER FOR viaGTWORLD TO FCMB HUSAINI AMINUReF GW,VALUE ADDED TAX VAT ON NIPTRANSFER FOR via GTWORLD TO FCMB HUSAINI AMINUReF GW,tax
27-Dec-2020,'0NIPT,27-Dec-2020,,"20,000.00","24,655.91",TRANSFER BETWEEN CUSTOMERS100004201227141611100314406715|Transfer fromto ASHAFA IBRAHIMABDULLAHI|100004201227141611100314406715||ABDULAZEEZ IBRAHIM ADAMUREF:100004201227141611100314406715,SAVINGS ACCOUNT,GT_Bank,./static/raw/MR_IBRAHIM_ASHAFA_STATEMENT.pdf,TRANSFER BETWEEN CUSTOMERS Transfer fromto ASHAFA IBRAHIMABDULLAHI ABDULAZEEZ IBRAHIM ADAMUREF,TRANSFER BETWEEN CUSTOMERS Transfer from to ASHAFA IBRAHIMABDULLAHI ABDULAZEEZ IBRAHIM ADAMUREF,transfert
27-Dec-2020,'0,27-Dec-2020,50.00,,"24,605.91",STAMP DUTY CHARGE 27122020 STAMP DUTY CHARGE - 27/12/2020,SAVINGS ACCOUNT,GT_Bank,./static/raw/MR_IBRAHIM_ASHAFA_STATEMENT.pdf,STAMP DUTY CHARGE STAMP DUTY CHARGE,STAMP DUTY CHARGE STAMP DUTY CHARGE,bank_charges
28-Dec-2020,'0USAT,28-Dec-2020,500.00,,"24,105.91",Airtime Purchase GTWORLD_QL- 101CT0000000002252959865-2348038673032,SAVINGS ACCOUNT,GT_Bank,./static/raw/MR_IBRAHIM_ASHAFA_STATEMENT.pdf,Airtime Purchase GTWORLD_QL CT,Airtime Purchase GTWORLDQL CT,utility
30-Dec-2020,'0NIPU,30-Dec-2020,"9,900.00",,"14,205.91",NIBSS Instant Payment Outward 000013201230130235000315523324 USSD NIP Transfer from  08038673032  TO UBA/YAKUBU USMAN /26.875/REF:000013201230130235000315523324,SAVINGS ACCOUNT,GT_Bank,./static/raw/MR_IBRAHIM_ASHAFA_STATEMENT.pdf,NIBSS Instant Payment Outward USSD NIP Transfer from TO UBA YAKUBU USMAN REF,NIBSS Instant Payment Outward USSD NIP Transfer from TO UBA YAKUBU USMAN REF,transfert
30-Dec-2020,'0NIPU,30-Dec-2020,25.00,,"14,180.91",COMMISSION 000013201230130235000315523324 USSD NIP RECOVERY CHARGE ReF:000013201230130235000315523324,SAVINGS ACCOUNT,GT_Bank,./static/raw/MR_IBRAHIM_ASHAFA_STATEMENT.pdf,COMMISSION USSD NIP RECOVERY CHARGE ReF,COMMISSION USSD NIP RECOVERY CHARGE ReF,transfert
30-Dec-2020,'0NIPU,30-Dec-2020,1.87,,"14,179.04",VALUE ADDED TAX 000013201230130235000315523324 VAT ON USSD NIP RECOVERY CHARGE ReF:000013201230130235000315523324,SAVINGS ACCOUNT,GT_Bank,./static/raw/MR_IBRAHIM_ASHAFA_STATEMENT.pdf,VALUE ADDED TAX VAT ON USSD NIP RECOVERY CHARGE ReF,VALUE ADDED TAX VAT ON USSD NIP RECOVERY CHARGE ReF,tax
30-Dec-2020,'0NIPU,30-Dec-2020,"3,000.00",,"11,179.04",NIBSS Instant Payment Outward 000013201230130451000315527425 USSD NIP Transfer from  08038673032  TO UBA/YUSUF HASSAN /10.75/REF:000013201230130451000315527425,SAVINGS ACCOUNT,GT_Bank,./static/raw/MR_IBRAHIM_ASHAFA_STATEMENT.pdf,NIBSS Instant Payment Outward USSD NIP Transfer from TO UBA YUSUF HASSAN REF,NIBSS Instant Payment Outward USSD NIP Transfer from TO UBA YUSUF HASSAN REF,transfert
30-Dec-2020,'0NIPU,30-Dec-2020,10.00,,"11,169.04",COMMISSION 000013201230130451000315527425 USSD NIP RECOVERY CHARGE ReF:000013201230130451000315527425,SAVINGS ACCOUNT,GT_Bank,./static/raw/MR_IBRAHIM_ASHAFA_STATEMENT.pdf,COMMISSION USSD NIP RECOVERY CHARGE ReF,COMMISSION USSD NIP RECOVERY CHARGE ReF,transfert
30-Dec-2020,'0NIPU,30-Dec-2020,.75,,"11,168.29",VALUE ADDED TAX 000013201230130451000315527425 VAT ON USSD NIP RECOVERY CHARGE ReF:000013201230130451000315527425,SAVINGS ACCOUNT,GT_Bank,./static/raw/MR_IBRAHIM_ASHAFA_STATEMENT.pdf,VALUE ADDED TAX VAT ON USSD NIP RECOVERY CHARGE ReF,VALUE ADDED TAX VAT ON USSD NIP RECOVERY CHARGE ReF,tax
30-Dec-2020,'0USAT,30-Dec-2020,"1,000.00",,"10,168.29",Airtime Purchase USSD- 101CT0000000002258221962-2348038673032,SAVINGS ACCOUNT,GT_Bank,./static/raw/MR_IBRAHIM_ASHAFA_STATEMENT.pdf,Airtime Purchase USSD CT,Airtime Purchase USSD CT,utility
31-Dec-2020,'0GWTR,31-Dec-2020,"1,000.00",,"9,168.29",TRANSFER BETWEEN CUSTOMERS Via GTWorld REF:681976569000000010002012311033  from ASHAFA IBRAHIM ABDULLAHI  to  ALIYU MUHAMMED USENI,SAVINGS ACCOUNT,GT_Bank,./static/raw/MR_IBRAHIM_ASHAFA_STATEMENT.pdf,TRANSFER BETWEEN CUSTOMERS Via GTWorld REF from ASHAFA IBRAHIM ABDULLAHI to ALIYU MUHAMMED USENI,TRANSFER BETWEEN CUSTOMERS Via GTWorld REF from ASHAFA IBRAHIM ABDULLAHI to ALIYU MUHAMMED USENI,transfert
31-Dec-2020,'0NIPG,31-Dec-2020,"5,500.00",,"3,668.29",NIBSS Instant Payment Outward 000013201231105342000316908474 viaGTWORLD  TO UBA/YAKUBU ASHAFAABDULLAHI/26.875/REF:GW6819765690000000550020123110f,SAVINGS ACCOUNT,GT_Bank,./static/raw/MR_IBRAHIM_ASHAFA_STATEMENT.pdf,NIBSS Instant Payment Outward viaGTWORLD TO UBA YAKUBU ASHAFAABDULLAHI REF GW f,NIBSS Instant Payment Outward via GTWORLD TO UBA YAKUBU ASHAFAABDULLAHI REF GW,transfert
31-Dec-2020,'0NIPG,31-Dec-2020,25.00,,"3,643.29",COMMISSION 000013201231105342000316908474NIP TRANSFER COMMISSION FOR000013201231105342000316908474 viaGTWORLD  TO UBA/YAKUBU ASHAFAABDULLAHIReF:GW681976569000000055002012311052,SAVINGS ACCOUNT,GT_Bank,./static/raw/MR_IBRAHIM_ASHAFA_STATEMENT.pdf,COMMISSION NIP TRANSFER COMMISSION FOR viaGTWORLD TO UBA YAKUBU ASHAFAABDULLAHIReF GW,COMMISSION NIP TRANSFER COMMISSION FOR via GTWORLD TO UBA YAKUBU ASHAFAABDULLAHIReF GW,commission
31-Dec-2020,'0NIPG,31-Dec-2020,1.87,,"3,641.42",VALUE ADDED TAX000013201231105342000316908474 VAT ON NIPTRANSFER FOR000013201231105342000316908474 viaGTWORLD  TO UBA/YAKUBU ASHAFAABDULLAHIReF:GW681976569000000055002012311052,SAVINGS ACCOUNT,GT_Bank,./static/raw/MR_IBRAHIM_ASHAFA_STATEMENT.pdf,VALUE ADDED TAX VAT ON NIPTRANSFER FOR viaGTWORLD TO UBA YAKUBU ASHAFAABDULLAHIReF GW,VALUE ADDED TAX VAT ON NIPTRANSFER FOR via GTWORLD TO UBA YAKUBU ASHAFAABDULLAHIReF GW,tax
01-Jan-2021,'41200012072,31-Dec-2020,"26,529.45",,"-22,888.03",MATURED LOAN INSTALLMENT,SAVINGS ACCOUNT,GT_Bank,./static/raw/MR_IBRAHIM_ASHAFA_STATEMENT.pdf,MATURED LOAN INSTALLMENT,MATURED LOAN INSTALLMENT,loan
01-Jan-2021,'0,31-Dec-2020,241.65,,"-23,129.68",INTEREST CAPITALISED,SAVINGS ACCOUNT,GT_Bank,./static/raw/MR_IBRAHIM_ASHAFA_STATEMENT.pdf,INTEREST CAPITALISED,INTEREST CAPITALISED,loan
01-Jan-2021,'0USAT,01-Jan-2021,700.00,,"-23,829.68",Airtime Purchase GTWORLD_QL-101CT0000000002263278181-2348038673032,SAVINGS ACCOUNT,GT_Bank,./static/raw/MR_IBRAHIM_ASHAFA_STATEMENT.pdf,Airtime Purchase GTWORLD_QL CT,Airtime Purchase GTWORLDQL CT,utility
01-Jan-2021,'0MBTR,01-Jan-2021,,"10,000.00","-13,829.68","TRANSFER BETWEEN CUSTOMERS MBANKING -REF:714566405297055200003124814241 ANYAccount Transferfrom EHIOGU, BERNARD UCHEto  ASHAFA IBRAHIM ABDULLAHI",SAVINGS ACCOUNT,GT_Bank,./static/raw/MR_IBRAHIM_ASHAFA_STATEMENT.pdf,TRANSFER BETWEEN CUSTOMERS MBANKING REF ANYAccount Transferfrom EHIOGU BERNARD UCHEto ASHAFA IBRAHIM ABDULLAHI,TRANSFER BETWEEN CUSTOMERS MBANKING REF ANYAccount Transferfrom EHIOGU BERNARD UCHEto ASHAFA IBRAHIM ABDULLAHI,transfert
01-Jan-2021,'0NIPG,01-Jan-2021,"6,000.00",,"-19,829.68",NIBSS Instant Payment Outward000013210101131534000318536356 viaGTWORLD  TO UBA/YUSUF HASSAN/26.875/REF:GW6819765690000000600021010113f,SAVINGS ACCOUNT,GT_Bank,./static/raw/MR_IBRAHIM_ASHAFA_STATEMENT.pdf,NIBSS Instant Payment Outward viaGTWORLD TO UBA YUSUF HASSAN REF GW f,NIBSS Instant Payment Outward via GTWORLD TO UBA YUSUF HASSAN REF GW,transfert
01-Jan-2021,'0NIPG,01-Jan-2021,25.00,,"-19,854.68",COMMISSION 000013210101131534000318536356NIP TRANSFER COMMISSION FOR000013210101131534000318536356 viaGTWORLD  TO UBA/YUSUF HASSANReF:GW681976569000000060002101011314,SAVINGS ACCOUNT,GT_Bank,./static/raw/MR_IBRAHIM_ASHAFA_STATEMENT.pdf,COMMISSION NIP TRANSFER COMMISSION FOR viaGTWORLD TO UBA YUSUF HASSANReF GW,COMMISSION NIP TRANSFER COMMISSION FOR via GTWORLD TO UBA YUSUF HASSANReF GW,commission
01-Jan-2021,'0NIPG,01-Jan-2021,1.87,,"-19,856.55",VALUE ADDED TAX000013210101131534000318536356 VAT ON NIPTRANSFER FOR000013210101131534000318536356 viaGTWORLD  TO UBA/YUSUF HASSANReF:GW681976569000000060002101011314,SAVINGS ACCOUNT,GT_Bank,./static/raw/MR_IBRAHIM_ASHAFA_STATEMENT.pdf,VALUE ADDED TAX VAT ON NIPTRANSFER FOR viaGTWORLD TO UBA YUSUF HASSANReF GW,VALUE ADDED TAX VAT ON NIPTRANSFER FOR via GTWORLD TO UBA YUSUF HASSANReF GW,tax
01-Jan-2021,'0NIPG,01-Jan-2021,"1,500.00",,"-21,356.55",NIBSS Instant Payment Outward000013210101174033000318814656 viaGTWORLD  TO FBN/ABUBAKAR ZAID/10.75/REF:GW6819765690000000150021010117  f,SAVINGS ACCOUNT,GT_Bank,./static/raw/MR_IBRAHIM_ASHAFA_STATEMENT.pdf,NIBSS Instant Payment Outward viaGTWORLD TO FBN ABUBAKAR ZAID REF GW f,NIBSS Instant Payment Outward via GTWORLD TO FBN ABUBAKAR ZAID REF GW,transfert
01-Jan-2021,'0NIPG,01-Jan-2021,10.00,,"-21,366.55",COMMISSION 000013210101174033000318814656NIP TRANSFER COMMISSION FOR000013210101174033000318814656 viaGTWORLD  TO FBN/ABUBAKAR ZAIDReF:GW681976569000000015002101011739,SAVINGS ACCOUNT,GT_Bank,./static/raw/MR_IBRAHIM_ASHAFA_STATEMENT.pdf,COMMISSION NIP TRANSFER COMMISSION FOR viaGTWORLD TO FBN ABUBAKAR ZAIDReF GW,COMMISSION NIP TRANSFER COMMISSION FOR via GTWORLD TO FBN ABUBAKAR ZAIDReF GW,commission
01-Jan-2021,'0NIPG,01-Jan-2021,.75,,"-21,367.30",VALUE ADDED TAX000013210101174033000318814656 VAT ON NIPTRANSFER FOR000013210101174033000318814656 viaGTWORLD  TO FBN/ABUBAKAR ZAIDReF:GW681976569000000015002101011739,SAVINGS ACCOUNT,GT_Bank,./static/raw/MR_IBRAHIM_ASHAFA_STATEMENT.pdf,VALUE ADDED TAX VAT ON NIPTRANSFER FOR viaGTWORLD TO FBN ABUBAKAR ZAIDReF GW,VALUE ADDED TAX VAT ON NIPTRANSFER FOR via GTWORLD TO FBN ABUBAKAR ZAIDReF GW,tax
02-Jan-2021,'0NIPG,02-Jan-2021,"2,500.00",,"-23,867.30",NIBSS Instant Payment Outward000013210102071748000319158459 viaGTWORLD  TO UBA/YAKUBU ASHAFAABDULLAHI/10.75/REF:GW6819765690000000250021010207  f,SAVINGS ACCOUNT,GT_Bank,./static/raw/MR_IBRAHIM_ASHAFA_STATEMENT.pdf,NIBSS Instant Payment Outward viaGTWORLD TO UBA YAKUBU ASHAFAABDULLAHI REF GW f,NIBSS Instant Payment Outward via GTWORLD TO UBA YAKUBU ASHAFAABDULLAHI REF GW,transfert
02-Jan-2021,'0NIPG,02-Jan-2021,10.00,,"-23,877.30",COMMISSION 000013210102071748000319158459NIP TRANSFER COMMISSION FOR000013210102071748000319158459 viaGTWORLD  TO UBA/YAKUBU ASHAFAABDULLAHIReF:GW681976569000000025002101020716,SAVINGS ACCOUNT,GT_Bank,./static/raw/MR_IBRAHIM_ASHAFA_STATEMENT.pdf,COMMISSION NIP TRANSFER COMMISSION FOR viaGTWORLD TO UBA YAKUBU ASHAFAABDULLAHIReF GW,COMMISSION NIP TRANSFER COMMISSION FOR via GTWORLD TO UBA YAKUBU ASHAFAABDULLAHIReF GW,commission
02-Jan-2021,'0NIPG,02-Jan-2021,.75,,"-23,878.05",VALUE ADDED TAX000013210102071748000319158459 VAT ON NIPTRANSFER FOR000013210102071748000319158459 viaGTWORLD  TO UBA/YAKUBU ASHAFAABDULLAHIReF:GW681976569000000025002101020716,SAVINGS ACCOUNT,GT_Bank,./static/raw/MR_IBRAHIM_ASHAFA_STATEMENT.pdf,VALUE ADDED TAX VAT ON NIPTRANSFER FOR viaGTWORLD TO UBA YAKUBU ASHAFAABDULLAHIReF GW,VALUE ADDED TAX VAT ON NIPTRANSFER FOR via GTWORLD TO UBA YAKUBU ASHAFAABDULLAHIReF GW,tax
02-Jan-2021,'0NIPT,02-Jan-2021,,"80,000.00","56,121.95",TRANSFER BETWEEN CUSTOMERS000010210102095847111038084692|REF614819958 BO abdullahi ibrahim IFO ASHAFAIBRA|614819958||abdullahi ibrahim REF:000010210102095847111038084692,SAVINGS ACCOUNT,GT_Bank,./static/raw/MR_IBRAHIM_ASHAFA_STATEMENT.pdf,TRANSFER BETWEEN CUSTOMERS REF BO abdullahi ibrahim IFO ASHAFAIBRA abdullahi ibrahim REF,TRANSFER BETWEEN CUSTOMERS REF BO abdullahi ibrahim IFO ASHAFAIBRA abdullahi ibrahim REF,transfert
02-Jan-2021,'0NIPG,02-Jan-2021,"10,000.00",,"46,121.95",NIBSS Instant Payment Outward 000013210102110405000319383919 via GTWORLD  TO FBN/DEMIDE ENEYAMIRE JEMILATU /26.875/REF:GW6819765690000001000021010211 f,SAVINGS ACCOUNT,GT_Bank,./static/raw/MR_IBRAHIM_ASHAFA_STATEMENT.pdf,NIBSS Instant Payment Outward via GTWORLD TO FBN DEMIDE ENEYAMIRE JEMILATU REF GW f,NIBSS Instant Payment Outward via GTWORLD TO FBN DEMIDE ENEYAMIRE JEMILATU REF GW,transfert
02-Jan-2021,'0NIPG,02-Jan-2021,25.00,,"46,096.95",COMMISSION 000013210102110405000319383919 NIP TRANSFER COMMISSION FOR 000013210102110405000319383919 via GTWORLD  TO FBN/DEMIDE ENEYAMIRE JEMILATU ReF:GW681976569000000100002101021102,SAVINGS ACCOUNT,GT_Bank,./static/raw/MR_IBRAHIM_ASHAFA_STATEMENT.pdf,COMMISSION NIP TRANSFER COMMISSION FOR via GTWORLD TO FBN DEMIDE ENEYAMIRE JEMILATU ReF GW,COMMISSION NIP TRANSFER COMMISSION FOR via GTWORLD TO FBN DEMIDE ENEYAMIRE JEMILATU ReF GW,commission
02-Jan-2021,'0NIPG,02-Jan-2021,1.87,,"46,095.08",VALUE ADDED TAX 000013210102110405000319383919 VAT ON NIP TRANSFER FOR 000013210102110405000319383919 via GTWORLD  TO FBN/DEMIDE ENEYAMIRE JEMILATU ReF:GW681976569000000100002101021102,SAVINGS ACCOUNT,GT_Bank,./static/raw/MR_IBRAHIM_ASHAFA_STATEMENT.pdf,VALUE ADDED TAX VAT ON NIP TRANSFER FOR via GTWORLD TO FBN DEMIDE ENEYAMIRE JEMILATU ReF GW,VALUE ADDED TAX VAT ON NIP TRANSFER FOR via GTWORLD TO FBN DEMIDE ENEYAMIRE JEMILATU ReF GW,tax
02-Jan-2021,'0NIPG,02-Jan-2021,"3,000.00",,"43,095.08",NIBSS Instant Payment Outward 000013210102120519000319463530 via GTWORLD  TO UBA/ABUHURAIRA JIBRIN UMAR /10.75/REF:GW6819765690000000300021010212  f,SAVINGS ACCOUNT,GT_Bank,./static/raw/MR_IBRAHIM_ASHAFA_STATEMENT.pdf,NIBSS Instant Payment Outward via GTWORLD TO UBA ABUHURAIRA JIBRIN UMAR REF GW f,NIBSS Instant Payment Outward via GTWORLD TO UBA ABUHURAIRA JIBRIN UMAR REF GW,transfert
02-Jan-2021,'0NIPG,02-Jan-2021,10.00,,"43,085.08",COMMISSION 000013210102120519000319463530 NIP TRANSFER COMMISSION FOR 000013210102120519000319463530 via GTWORLD  TO UBA/ABUHURAIRA JIBRIN UMAR ReF:GW681976569000000030002101021203,SAVINGS ACCOUNT,GT_Bank,./static/raw/MR_IBRAHIM_ASHAFA_STATEMENT.pdf,COMMISSION NIP TRANSFER COMMISSION FOR via GTWORLD TO UBA ABUHURAIRA JIBRIN UMAR ReF GW,COMMISSION NIP TRANSFER COMMISSION FOR via GTWORLD TO UBA ABUHURAIRA JIBRIN UMAR ReF GW,commission
02-Jan-2021,'0NIPG,02-Jan-2021,.75,,"43,084.33",VALUE ADDED TAX 000013210102120519000319463530 VAT ON NIP TRANSFER FOR 000013210102120519000319463530 via GTWORLD  TO UBA/ABUHURAIRA JIBRIN UMAR ReF:GW681976569000000030002101021203,SAVINGS ACCOUNT,GT_Bank,./static/raw/MR_IBRAHIM_ASHAFA_STATEMENT.pdf,VALUE ADDED TAX VAT ON NIP TRANSFER FOR via GTWORLD TO UBA ABUHURAIRA JIBRIN UMAR ReF GW,VALUE ADDED TAX VAT ON NIP TRANSFER FOR via GTWORLD TO UBA ABUHURAIRA JIBRIN UMAR ReF GW,tax
02-Jan-2021,'0NIPG,02-Jan-2021,"20,000.00",,"23,084.33",NIBSS Instant Payment Outward 000013210102121244000319473283 via GTWORLD  TO TAJB/IBRAHIM ASHAFA/26.875/REF:GW6819765690000002000021010212 f,SAVINGS ACCOUNT,GT_Bank,./static/raw/MR_IBRAHIM_ASHAFA_STATEMENT.pdf,NIBSS Instant Payment Outward via GTWORLD TO TAJB IBRAHIM ASHAFA REF GW f,NIBSS Instant Payment Outward via GTWORLD TO TAJB IBRAHIM ASHAFA REF GW,transfert
02-Jan-2021,'0NIPG,02-Jan-2021,25.00,,"23,059.33",COMMISSION 000013210102121244000319473283 NIP TRANSFER COMMISSION FOR 000013210102121244000319473283 via GTWORLD  TO TAJB/IBRAHIM ASHAFA ReF:GW681976569000000200002101021211,SAVINGS ACCOUNT,GT_Bank,./static/raw/MR_IBRAHIM_ASHAFA_STATEMENT.pdf,COMMISSION NIP TRANSFER COMMISSION FOR via GTWORLD TO TAJB IBRAHIM ASHAFA ReF GW,COMMISSION NIP TRANSFER COMMISSION FOR via GTWORLD TO TAJB IBRAHIM ASHAFA ReF GW,commission
02-Jan-2021,'0NIPG,02-Jan-2021,1.87,,"23,057.46",VALUE ADDED TAX 000013210102121244000319473283 VAT ON NIP TRANSFER FOR 000013210102121244000319473283 via GTWORLD  TO TAJB/IBRAHIM ASHAFA ReF:GW681976569000000200002101021211,SAVINGS ACCOUNT,GT_Bank,./static/raw/MR_IBRAHIM_ASHAFA_STATEMENT.pdf,VALUE ADDED TAX VAT ON NIP TRANSFER FOR via GTWORLD TO TAJB IBRAHIM ASHAFA ReF GW,VALUE ADDED TAX VAT ON NIP TRANSFER FOR via GTWORLD TO TAJB IBRAHIM ASHAFA ReF GW,tax
02-Jan-2021,'0,02-Jan-2021,50.00,,"23,007.46",STAMP DUTY CHARGE 02012021 STAMP DUTY CHARGE - 02/01/2021,SAVINGS ACCOUNT,GT_Bank,./static/raw/MR_IBRAHIM_ASHAFA_STATEMENT.pdf,STAMP DUTY CHARGE STAMP DUTY CHARGE,STAMP DUTY CHARGE STAMP DUTY CHARGE,bank_charges
03-Jan-2021,'0NIPG,03-Jan-2021,"1,000.00",,"22,007.46",NIBSS Instant Payment Outward 000013210103091441000320303946 via GTWORLD  TO UBA/SALIHU KABIRU NAMAMA /10.75/REF:GW6819765690000000100021010309  f,SAVINGS ACCOUNT,GT_Bank,./static/raw/MR_IBRAHIM_ASHAFA_STATEMENT.pdf,NIBSS Instant Payment Outward via GTWORLD TO UBA SALIHU KABIRU NAMAMA REF GW f,NIBSS Instant Payment Outward via GTWORLD TO UBA SALIHU KABIRU NAMAMA REF GW,transfert
03-Jan-2021,'0NIPG,03-Jan-2021,10.00,,"21,997.46",COMMISSION 000013210103091441000320303946 NIP TRANSFER COMMISSION FOR 000013210103091441000320303946 via GTWORLD  TO UBA/SALIHU KABIRU NAMAMA ReF:GW681976569000000010002101030913,SAVINGS ACCOUNT,GT_Bank,./static/raw/MR_IBRAHIM_ASHAFA_STATEMENT.pdf,COMMISSION NIP TRANSFER COMMISSION FOR via GTWORLD TO UBA SALIHU KABIRU NAMAMA ReF GW,COMMISSION NIP TRANSFER COMMISSION FOR via GTWORLD TO UBA SALIHU KABIRU NAMAMA ReF GW,commission
03-Jan-2021,'0NIPG,03-Jan-2021,.75,,"21,996.71",VALUE ADDED TAX 000013210103091441000320303946 VAT ON NIP TRANSFER FOR 000013210103091441000320303946 via GTWORLD  TO UBA/SALIHU KABIRU NAMAMA ReF:GW681976569000000010002101030913,SAVINGS ACCOUNT,GT_Bank,./static/raw/MR_IBRAHIM_ASHAFA_STATEMENT.pdf,VALUE ADDED TAX VAT ON NIP TRANSFER FOR via GTWORLD TO UBA SALIHU KABIRU NAMAMA ReF GW,VALUE ADDED TAX VAT ON NIP TRANSFER FOR via GTWORLD TO UBA SALIHU KABIRU NAMAMA ReF GW,tax
03-Jan-2021,'0USAT,03-Jan-2021,300.00,,"21,696.71",Airtime Purchase GTWORLD_QL- 101CT0000000002268282427-2348038673032,SAVINGS ACCOUNT,GT_Bank,./static/raw/MR_IBRAHIM_ASHAFA_STATEMENT.pdf,Airtime Purchase GTWORLD_QL CT,Airtime Purchase GTWORLDQL CT,utility
04-Jan-2021,'99996915979999,04-Jan-2021,"4,600.00",,"17,096.71",POS/WEB PURCHASE TRANSACTION  -691597- - 815534-COSMIC INTELLIGENT L   LANG           NG,SAVINGS ACCOUNT,GT_Bank,./static/raw/MR_IBRAHIM_ASHAFA_STATEMENT.pdf,POS WEB PURCHASE TRANSACTION COSMIC INTELLIGENT L LANG NG,POS WEB PURCHASE TRANSACTION COSMIC INTELLIGENTLANG NG,others
05-Jan-2021,'0NIPG,05-Jan-2021,"5,000.00",,"12,096.71",NIBSS Instant Payment Outward 000013210105144939000323023719 via GTWORLD  TO UBA/YAKUBU ASHAFA ABDULLAHI/10.75/REF:GW6819765690000000500021010514  f,SAVINGS ACCOUNT,GT_Bank,./static/raw/MR_IBRAHIM_ASHAFA_STATEMENT.pdf,NIBSS Instant Payment Outward via GTWORLD TO UBA YAKUBU ASHAFA ABDULLAHI REF GW f,NIBSS Instant Payment Outward via GTWORLD TO UBA YAKUBU ASHAFA ABDULLAHI REF GW,transfert
05-Jan-2021,'0NIPG,05-Jan-2021,10.00,,"12,086.71",COMMISSION 000013210105144939000323023719 NIP TRANSFER COMMISSION FOR 000013210105144939000323023719 via GTWORLD  TO UBA/YAKUBU ASHAFA ABDULLAHI ReF:GW681976569000000050002101051448,SAVINGS ACCOUNT,GT_Bank,./static/raw/MR_IBRAHIM_ASHAFA_STATEMENT.pdf,COMMISSION NIP TRANSFER COMMISSION FOR via GTWORLD TO UBA YAKUBU ASHAFA ABDULLAHI ReF GW,COMMISSION NIP TRANSFER COMMISSION FOR via GTWORLD TO UBA YAKUBU ASHAFA ABDULLAHI ReF GW,commission
05-Jan-2021,'0NIPG,05-Jan-2021,.75,,"12,085.96",VALUE ADDED TAX 000013210105144939000323023719 VAT ON NIP TRANSFER FOR 000013210105144939000323023719 via GTWORLD  TO UBA/YAKUBU ASHAFA ABDULLAHI ReF:GW681976569000000050002101051448,SAVINGS ACCOUNT,GT_Bank,./static/raw/MR_IBRAHIM_ASHAFA_STATEMENT.pdf,VALUE ADDED TAX VAT ON NIP TRANSFER FOR via GTWORLD TO UBA YAKUBU ASHAFA ABDULLAHI ReF GW,VALUE ADDED TAX VAT ON NIP TRANSFER FOR via GTWORLD TO UBA YAKUBU ASHAFA ABDULLAHI ReF GW,tax
05-Jan-2021,'0NIPG,05-Jan-2021,"3,000.00",,"9,085.96",NIBSS Instant Payment Outward 000013210105190817000323385563 via GTWORLD  TO UBA/ASHAFA USMAN ABDULLAHI /10.75/REF:GW6819765690000000300021010519  f,SAVINGS ACCOUNT,GT_Bank,./static/raw/MR_IBRAHIM_ASHAFA_STATEMENT.pdf,NIBSS Instant Payment Outward via GTWORLD TO UBA ASHAFA USMAN ABDULLAHI REF GW f,NIBSS Instant Payment Outward via GTWORLD TO UBA ASHAFA USMAN ABDULLAHI REF GW,transfert
05-Jan-2021,'0NIPG,05-Jan-2021,10.00,,"9,075.96",COMMISSION 000013210105190817000323385563 NIP TRANSFER COMMISSION FOR 000013210105190817000323385563 via GTWORLD  TO UBA/ASHAFA USMAN ABDULLAHI ReF:GW681976569000000030002101051906,SAVINGS ACCOUNT,GT_Bank,./static/raw/MR_IBRAHIM_ASHAFA_STATEMENT.pdf,COMMISSION NIP TRANSFER COMMISSION FOR via GTWORLD TO UBA ASHAFA USMAN ABDULLAHI ReF GW,COMMISSION NIP TRANSFER COMMISSION FOR via GTWORLD TO UBA ASHAFA USMAN ABDULLAHI ReF GW,commission
05-Jan-2021,'0NIPG,05-Jan-2021,.75,,"9,075.21",VALUE ADDED TAX 000013210105190817000323385563 VAT ON NIP TRANSFER FOR 000013210105190817000323385563 via GTWORLD  TO UBA/ASHAFA USMAN ABDULLAHI ReF:GW681976569000000030002101051906,SAVINGS ACCOUNT,GT_Bank,./static/raw/MR_IBRAHIM_ASHAFA_STATEMENT.pdf,VALUE ADDED TAX VAT ON NIP TRANSFER FOR via GTWORLD TO UBA ASHAFA USMAN ABDULLAHI ReF GW,VALUE ADDED TAX VAT ON NIP TRANSFER FOR via GTWORLD TO UBA ASHAFA USMAN ABDULLAHI ReF GW,tax
06-Jan-2021,'0NIPG,06-Jan-2021,"6,000.00",,"3,075.21",NIBSS Instant Payment Outward 000013210106063931000323679400 via GTWORLD  TO UBA/YAKUBU ASHAFA ABDULLAHI /26.875/REF:GW6819765690000000600021010606 f,SAVINGS ACCOUNT,GT_Bank,./static/raw/MR_IBRAHIM_ASHAFA_STATEMENT.pdf,NIBSS Instant Payment Outward via GTWORLD TO UBA YAKUBU ASHAFA ABDULLAHI REF GW f,NIBSS Instant Payment Outward via GTWORLD TO UBA YAKUBU ASHAFA ABDULLAHI REF GW,transfert
06-Jan-2021,'0NIPG,06-Jan-2021,25.00,,"3,050.21",COMMISSION 000013210106063931000323679400 NIP TRANSFER COMMISSION FOR 000013210106063931000323679400 via GTWORLD  TO UBA/YAKUBU ASHAFAABDULLAHI ReF:GW681976569000000060002101060638,SAVINGS ACCOUNT,GT_Bank,./static/raw/MR_IBRAHIM_ASHAFA_STATEMENT.pdf,COMMISSION NIP TRANSFER COMMISSION FOR via GTWORLD TO UBA YAKUBU ASHAFAABDULLAHI ReF GW,COMMISSION NIP TRANSFER COMMISSION FOR via GTWORLD TO UBA YAKUBU ASHAFAABDULLAHI ReF GW,commission
06-Jan-2021,'0NIPG,06-Jan-2021,1.87,,"3,048.34",VALUE ADDED TAX 000013210106063931000323679400 VAT ON NIP TRANSFER FOR 000013210106063931000323679400 via GTWORLD  TO UBA/YAKUBU ASHAFA ABDULLAHI ReF:GW681976569000000060002101060638,SAVINGS ACCOUNT,GT_Bank,./static/raw/MR_IBRAHIM_ASHAFA_STATEMENT.pdf,VALUE ADDED TAX VAT ON NIP TRANSFER FOR via GTWORLD TO UBA YAKUBU ASHAFA ABDULLAHI ReF GW,VALUE ADDED TAX VAT ON NIP TRANSFER FOR via GTWORLD TO UBA YAKUBU ASHAFA ABDULLAHI ReF GW,tax
06-Jan-2021,'0USAT,06-Jan-2021,800.00,,"2,248.34",Airtime Purchase GTWORLD- 101CT0000000002273441952-2348038673032,SAVINGS ACCOUNT,GT_Bank,./static/raw/MR_IBRAHIM_ASHAFA_STATEMENT.pdf,Airtime Purchase GTWORLD CT,Airtime Purchase GTWORLD CT,utility
06-Jan-2021,'0NIPG,06-Jan-2021,"5,000.00",,"-2,751.66",NIBSS Instant Payment Outward 000013210106152923000324390613 via GTWORLD  TO UBA/YUSUF HASSAN /10.75/REF:GW6819765690000000500021010615  f,SAVINGS ACCOUNT,GT_Bank,./static/raw/MR_IBRAHIM_ASHAFA_STATEMENT.pdf,NIBSS Instant Payment Outward via GTWORLD TO UBA YUSUF HASSAN REF GW f,NIBSS Instant Payment Outward via GTWORLD TO UBA YUSUF HASSAN REF GW,transfert
06-Jan-2021,'0NIPG,06-Jan-2021,10.00,,"-2,761.66",COMMISSION 000013210106152923000324390613 NIP TRANSFER COMMISSION FOR 000013210106152923000324390613 via GTWORLD  TO UBA/YUSUF HASSAN ReF:GW681976569000000050002101061527,SAVINGS ACCOUNT,GT_Bank,./static/raw/MR_IBRAHIM_ASHAFA_STATEMENT.pdf,COMMISSION NIP TRANSFER COMMISSION FOR via GTWORLD TO UBA YUSUF HASSAN ReF GW,COMMISSION NIP TRANSFER COMMISSION FOR via GTWORLD TO UBA YUSUF HASSAN ReF GW,commission
06-Jan-2021,'0NIPG,06-Jan-2021,.75,,"-2,762.41",VALUE ADDED TAX 000013210106152923000324390613 VAT ON NIP TRANSFER FOR 000013210106152923000324390613 via GTWORLD  TO UBA/YUSUF HASSAN ReF:GW681976569000000050002101061527,SAVINGS ACCOUNT,GT_Bank,./static/raw/MR_IBRAHIM_ASHAFA_STATEMENT.pdf,VALUE ADDED TAX VAT ON NIP TRANSFER FOR via GTWORLD TO UBA YUSUF HASSAN ReF GW,VALUE ADDED TAX VAT ON NIP TRANSFER FOR via GTWORLD TO UBA YUSUF HASSAN ReF GW,tax
08-Jan-2021,'0NIPG,08-Jan-2021,"5,000.00",,"-7,762.41",NIBSS Instant Payment Outward 000013210108165229000327186939 via GTWORLD  TO UBA/YAKUBU ASHAFA ABDULLAHI /10.75/REF:GW6819765690000000500021010816  f,SAVINGS ACCOUNT,GT_Bank,./static/raw/MR_IBRAHIM_ASHAFA_STATEMENT.pdf,NIBSS Instant Payment Outward via GTWORLD TO UBA YAKUBU ASHAFA ABDULLAHI REF GW f,NIBSS Instant Payment Outward via GTWORLD TO UBA YAKUBU ASHAFA ABDULLAHI REF GW,transfert
08-Jan-2021,'0NIPG,08-Jan-2021,10.00,,"-7,772.41",COMMISSION 000013210108165229000327186939 NIP TRANSFER COMMISSION FOR 000013210108165229000327186939 via GTWORLD  TO UBA/YAKUBU ASHAFA ABDULLAHI ReF:GW681976569000000050002101081651,SAVINGS ACCOUNT,GT_Bank,./static/raw/MR_IBRAHIM_ASHAFA_STATEMENT.pdf,COMMISSION NIP TRANSFER COMMISSION FOR via GTWORLD TO UBA YAKUBU ASHAFA ABDULLAHI ReF GW,COMMISSION NIP TRANSFER COMMISSION FOR via GTWORLD TO UBA YAKUBU ASHAFA ABDULLAHI ReF GW,commission
08-Jan-2021,'0NIPG,08-Jan-2021,.75,,"-7,773.16",VALUE ADDED TAX000013210108165229000327186939 VAT ON NIP TRANSFER FOR 000013210108165229000327186939 via GTWORLD  TO UBA/YAKUBU ASHAFA ABDULLAHI ReF:GW681976569000000050002101081651,SAVINGS ACCOUNT,GT_Bank,./static/raw/MR_IBRAHIM_ASHAFA_STATEMENT.pdf,VALUE ADDED TAX VAT ON NIP TRANSFER FOR via GTWORLD TO UBA YAKUBU ASHAFA ABDULLAHI ReF GW,VALUE ADDED TAX VAT ON NIP TRANSFER FOR via GTWORLD TO UBA YAKUBU ASHAFA ABDULLAHI ReF GW,tax
08-Jan-2021,'0USAT,08-Jan-2021,700.00,,"-8,473.16",Airtime Purchase GTWORLD_QL- 101CT0000000002280201060-2348030549818,SAVINGS ACCOUNT,GT_Bank,./static/raw/MR_IBRAHIM_ASHAFA_STATEMENT.pdf,Airtime Purchase GTWORLD_QL CT,Airtime Purchase GTWORLDQL CT,utility
08-Jan-2021,'0USAT,08-Jan-2021,400.00,,"-8,873.16",Airtime Purchase GTWORLD_QL- 101CT0000000002280202310-2348038673032,SAVINGS ACCOUNT,GT_Bank,./static/raw/MR_IBRAHIM_ASHAFA_STATEMENT.pdf,Airtime Purchase GTWORLD_QL CT,Airtime Purchase GTWORLDQL CT,utility
09-Jan-2021,'0NIPG,09-Jan-2021,"2,000.00",,"-10,873.16",NIBSS Instant Payment Outward 000013210109163321000328440219 via GTWORLD  TO UBA/YUSUF  SHEHU /10.75/REF:GW6819765690000000200021010916  f,SAVINGS ACCOUNT,GT_Bank,./static/raw/MR_IBRAHIM_ASHAFA_STATEMENT.pdf,NIBSS Instant Payment Outward via GTWORLD TO UBA YUSUF SHEHU REF GW f,NIBSS Instant Payment Outward via GTWORLD TO UBA YUSUF SHEHU REF GW,transfert
09-Jan-2021,'0NIPG,09-Jan-2021,10.00,,"-10,883.16",COMMISSION 000013210109163321000328440219 NIP TRANSFER COMMISSION FOR 000013210109163321000328440219 via GTWORLD  TO UBA/YUSUF  SHEHU ReF:GW681976569000000020002101091631,SAVINGS ACCOUNT,GT_Bank,./static/raw/MR_IBRAHIM_ASHAFA_STATEMENT.pdf,COMMISSION NIP TRANSFER COMMISSION FOR via GTWORLD TO UBA YUSUF SHEHU ReF GW,COMMISSION NIP TRANSFER COMMISSION FOR via GTWORLD TO UBA YUSUF SHEHU ReF GW,commission
09-Jan-2021,'0NIPG,09-Jan-2021,.75,,"-10,883.91",VALUE ADDED TAX 000013210109163321000328440219 VAT ON NIP TRANSFER FOR 000013210109163321000328440219 via GTWORLD  TO UBA/YUSUF  SHEHU ReF:GW681976569000000020002101091631,SAVINGS ACCOUNT,GT_Bank,./static/raw/MR_IBRAHIM_ASHAFA_STATEMENT.pdf,VALUE ADDED TAX VAT ON NIP TRANSFER FOR via GTWORLD TO UBA YUSUF SHEHU ReF GW,VALUE ADDED TAX VAT ON NIP TRANSFER FOR via GTWORLD TO UBA YUSUF SHEHU ReF GW,tax
09-Jan-2021,'0NIPG,09-Jan-2021,"1,000.00",,"-11,883.91",NIBSS Instant Payment Outward 000013210109163404000328441257 via GTWORLD  TO UBA/ZAINAB  UMAR /10.75/REF:GW6819765690000000100021010916  f,SAVINGS ACCOUNT,GT_Bank,./static/raw/MR_IBRAHIM_ASHAFA_STATEMENT.pdf,NIBSS Instant Payment Outward via GTWORLD TO UBA ZAINAB UMAR REF GW f,NIBSS Instant Payment Outward via GTWORLD TO UBA ZAINAB UMAR REF GW,transfert
09-Jan-2021,'0NIPG,09-Jan-2021,10.00,,"-11,893.91",COMMISSION 000013210109163404000328441257 NIP TRANSFER COMMISSION FOR 000013210109163404000328441257 via GTWORLD  TO UBA/ZAINAB  UMAR ReF:GW681976569000000010002101091632,SAVINGS ACCOUNT,GT_Bank,./static/raw/MR_IBRAHIM_ASHAFA_STATEMENT.pdf,COMMISSION NIP TRANSFER COMMISSION FOR via GTWORLD TO UBA ZAINAB UMAR ReF GW,COMMISSION NIP TRANSFER COMMISSION FOR via GTWORLD TO UBA ZAINAB UMAR ReF GW,commission
09-Jan-2021,'0NIPG,09-Jan-2021,.75,,"-11,894.66",VALUE ADDED TAX 000013210109163404000328441257 VAT ON NIP TRANSFER FOR 000013210109163404000328441257 viaGTWORLD  TO UBA/ZAINAB  UMARReF:GW681976569000000010002101091632,SAVINGS ACCOUNT,GT_Bank,./static/raw/MR_IBRAHIM_ASHAFA_STATEMENT.pdf,VALUE ADDED TAX VAT ON NIP TRANSFER FOR viaGTWORLD TO UBA ZAINAB UMARReF GW,VALUE ADDED TAX VAT ON NIP TRANSFER FOR via GTWORLD TO UBA ZAINAB UMARReF GW,tax
10-Jan-2021,'0USGT,10-Jan-2021,,"3,000.00","-8,894.66","TRANSFER BETWEEN CUSTOMERS Via USSDGTBank Transfer00000000325036130968109765690000003000202101100857  from SANI, IBRAHIM ASHAFA  toASHAFA IBRAHIM ABDULLAHI",SAVINGS ACCOUNT,GT_Bank,./static/raw/MR_IBRAHIM_ASHAFA_STATEMENT.pdf,TRANSFER BETWEEN CUSTOMERS Via USSDGTBank Transfer from SANI IBRAHIM ASHAFA toASHAFA IBRAHIM ABDULLAHI,TRANSFER BETWEEN CUSTOMERS Via USSDGTBank Transfer from SANI IBRAHIM ASHAFA toASHAFA IBRAHIM ABDULLAHI,transfert
10-Jan-2021,'0NIPT,10-Jan-2021,,"20,000.00","11,105.34",TRANSFER BETWEEN CUSTOMERS000004210110123731000949220878|MB/UTO/949220878/2348038509995/Trf to0131934493|2348038509995/949220878||ABDULLAHI ASHAFAREF:000004210110123731000949220878,SAVINGS ACCOUNT,GT_Bank,./static/raw/MR_IBRAHIM_ASHAFA_STATEMENT.pdf,TRANSFER BETWEEN CUSTOMERS MB UTO Trf to ABDULLAHI ASHAFAREF,TRANSFER BETWEEN CUSTOMERS MB UTO Trf to ABDULLAHI ASHAFAREF,transfert
10-Jan-2021,'0USAT,10-Jan-2021,500.00,,"10,605.34",Airtime Purchase GTWORLD_QL-101CT0000000002283548551-2348038673032,SAVINGS ACCOUNT,GT_Bank,./static/raw/MR_IBRAHIM_ASHAFA_STATEMENT.pdf,Airtime Purchase GTWORLD_QL CT,Airtime Purchase GTWORLDQL CT,utility
10-Jan-2021,'99997406479999,10-Jan-2021,"3,000.00",,"7,605.34",CASH WITHDRAWAL FROM OTHER ATM  -740647- -821263-000000000000738 New Wu AbujaNG,SAVINGS ACCOUNT,GT_Bank,./static/raw/MR_IBRAHIM_ASHAFA_STATEMENT.pdf,CASH WITHDRAWAL FROM OTHER ATM New Wu AbujaNG,CASH WITHDRAWAL FROM OTHER ATM New Wu AbujaNG,cash
10-Jan-2021,'0,10-Jan-2021,50.00,,"7,555.34",STAMP DUTY CHARGE 10012021 STAMP DUTYCHARGE - 10/01/2021,SAVINGS ACCOUNT,GT_Bank,./static/raw/MR_IBRAHIM_ASHAFA_STATEMENT.pdf,STAMP DUTY CHARGE STAMP DUTYCHARGE,STAMP DUTY CHARGE STAMP DUTYCHARGE,bank_charges
11-Jan-2021,'99997589369999,11-Jan-2021,"5,100.00",,"2,455.34",POS/WEB PURCHASE TRANSACTION  -758936- -090456-PAYARENALAGOSNG,SAVINGS ACCOUNT,GT_Bank,./static/raw/MR_IBRAHIM_ASHAFA_STATEMENT.pdf,POS WEB PURCHASE TRANSACTION PAYARENALAGOSNG,POS WEB PURCHASE TRANSACTION PAYARENALAGOSNG,utility
11-Jan-2021,'99999601589999,11-Jan-2021,"30,500.00",,"-28,044.66",POS/WEB PURCHASE TRANSACTION  -960158- -148223-PAYARENALAGOSNG,SAVINGS ACCOUNT,GT_Bank,./static/raw/MR_IBRAHIM_ASHAFA_STATEMENT.pdf,POS WEB PURCHASE TRANSACTION PAYARENALAGOSNG,POS WEB PURCHASE TRANSACTION PAYARENALAGOSNG,utility
12-Jan-2021,'0NIPT,12-Jan-2021,,"20,000.00","-8,044.66",TRANSFER BETWEEN CUSTOMERS000007210112094654324570259190|ONB TRFFROM RIKKO YILL **4943FBP|ONB21011209465506904||RIKKO YILLUWIRIKERENREF:000007210112094654324570259190,SAVINGS ACCOUNT,GT_Bank,./static/raw/MR_IBRAHIM_ASHAFA_STATEMENT.pdf,TRANSFER BETWEEN CUSTOMERS ONB TRFFROM RIKKO YILL FBP ONB RIKKO YILLUWIRIKERENREF,TRANSFER BETWEEN CUSTOMERS ONB TRFFROM RIKKO YILL FBP ONB RIKKO YILLUWIRIKERENREF,transfert
12-Jan-2021,'0USAT,12-Jan-2021,800.00,,"-8,844.66",Airtime Purchase GTWORLD_QL-101CT0000000002287349697-2348038673032,SAVINGS ACCOUNT,GT_Bank,./static/raw/MR_IBRAHIM_ASHAFA_STATEMENT.pdf,Airtime Purchase GTWORLD_QL CT,Airtime Purchase GTWORLDQL CT,utility
12-Jan-2021,'0NIPT,12-Jan-2021,,"10,000.00","1,155.34",TRANSFER BETWEEN CUSTOMERS000016210112164114000002233860|73301610466067125/FIP:GTBANKPLC/73301610466067125/DEPOSITTRANSACTION|73301610466067125||IDOWUFUNSHO REF:000016210112164114000002233860,SAVINGS ACCOUNT,GT_Bank,./static/raw/MR_IBRAHIM_ASHAFA_STATEMENT.pdf,TRANSFER BETWEEN CUSTOMERS FIP GTBANKPLC DEPOSITTRANSACTION IDOWUFUNSHO REF,TRANSFER BETWEEN CUSTOMERS FIP GTBANKPLC DEPOSITTRANSACTION IDOWUFUNSHO REF,transfert
12-Jan-2021,'0NIPG,12-Jan-2021,"25,000.00",,"-23,844.66",NIBSS Instant Payment Outward 000013210112164507000332121174 via GTWORLD  TO FBN/MUHAMMAD SULEIMAN /26.875/REF:GW6819765690000002500021011216 f,SAVINGS ACCOUNT,GT_Bank,./static/raw/MR_IBRAHIM_ASHAFA_STATEMENT.pdf,NIBSS Instant Payment Outward via GTWORLD TO FBN MUHAMMAD SULEIMAN REF GW f,NIBSS Instant Payment Outward via GTWORLD TO FBN MUHAMMAD SULEIMAN REF GW,transfert
12-Jan-2021,'0NIPG,12-Jan-2021,25.00,,"-23,869.66",COMMISSION 000013210112164507000332121174 NIP TRANSFER COMMISSION FOR 000013210112164507000332121174 via GTWORLD  TO FBN/MUHAMMAD SULEIMAN ReF:GW681976569000000250002101121643,SAVINGS ACCOUNT,GT_Bank,./static/raw/MR_IBRAHIM_ASHAFA_STATEMENT.pdf,COMMISSION NIP TRANSFER COMMISSION FOR via GTWORLD TO FBN MUHAMMAD SULEIMAN ReF GW,COMMISSION NIP TRANSFER COMMISSION FOR via GTWORLD TO FBN MUHAMMAD SULEIMAN ReF GW,commission
12-Jan-2021,'0NIPG,12-Jan-2021,1.87,,"-23,871.53",VALUE ADDED TAX 000013210112164507000332121174 VAT ON NIP TRANSFER FOR 000013210112164507000332121174 via GTWORLD  TO FBN/MUHAMMAD SULEIMAN ReF:GW681976569000000250002101121643,SAVINGS ACCOUNT,GT_Bank,./static/raw/MR_IBRAHIM_ASHAFA_STATEMENT.pdf,VALUE ADDED TAX VAT ON NIP TRANSFER FOR via GTWORLD TO FBN MUHAMMAD SULEIMAN ReF GW,VALUE ADDED TAX VAT ON NIP TRANSFER FOR via GTWORLD TO FBN MUHAMMAD SULEIMAN ReF GW,tax
12-Jan-2021,'0NIPG,12-Jan-2021,"2,000.00",,"-25,871.53",NIBSS Instant Payment Outward 000013210112164619000332123110 via GTWORLD  TO FBN/MUHAMMAD SULEIMAN /10.75/REF:GW6819765690000000200021011216  f,SAVINGS ACCOUNT,GT_Bank,./static/raw/MR_IBRAHIM_ASHAFA_STATEMENT.pdf,NIBSS Instant Payment Outward via GTWORLD TO FBN MUHAMMAD SULEIMAN REF GW f,NIBSS Instant Payment Outward via GTWORLD TO FBN MUHAMMAD SULEIMAN REF GW,transfert
12-Jan-2021,'0NIPG,12-Jan-2021,10.00,,"-25,881.53",COMMISSION 000013210112164619000332123110 NIP TRANSFER COMMISSION FOR 000013210112164619000332123110 via GTWORLD  TO FBN/MUHAMMAD SULEIMAN ReF:GW681976569000000020002101121644,SAVINGS ACCOUNT,GT_Bank,./static/raw/MR_IBRAHIM_ASHAFA_STATEMENT.pdf,COMMISSION NIP TRANSFER COMMISSION FOR via GTWORLD TO FBN MUHAMMAD SULEIMAN ReF GW,COMMISSION NIP TRANSFER COMMISSION FOR via GTWORLD TO FBN MUHAMMAD SULEIMAN ReF GW,commission
12-Jan-2021,'0NIPG,12-Jan-2021,.75,,"-25,882.28",VALUE ADDED TAX 000013210112164619000332123110 VAT ON NIP TRANSFER FOR 000013210112164619000332123110 via GTWORLD  TO FBN/MUHAMMAD SULEIMAN ReF:GW681976569000000020002101121644,SAVINGS ACCOUNT,GT_Bank,./static/raw/MR_IBRAHIM_ASHAFA_STATEMENT.pdf,VALUE ADDED TAX VAT ON NIP TRANSFER FOR via GTWORLD TO FBN MUHAMMAD SULEIMAN ReF GW,VALUE ADDED TAX VAT ON NIP TRANSFER FOR via GTWORLD TO FBN MUHAMMAD SULEIMAN ReF GW,tax
12-Jan-2021,'0USAT,12-Jan-2021,"1,000.00",,"-26,882.28",Airtime Purchase GTWORLD_QL- 101CT0000000002289070443-2348030549818,SAVINGS ACCOUNT,GT_Bank,./static/raw/MR_IBRAHIM_ASHAFA_STATEMENT.pdf,Airtime Purchase GTWORLD_QL CT,Airtime Purchase GTWORLDQL CT,utility
13-Jan-2021,'0USAT,12-Jan-2021,300.00,,"-27,182.28",Airtime Purchase GTWORLD_QL- 101CT0000000002289136908-2348036417835,SAVINGS ACCOUNT,GT_Bank,./static/raw/MR_IBRAHIM_ASHAFA_STATEMENT.pdf,Airtime Purchase GTWORLD_QL CT,Airtime Purchase GTWORLDQL CT,utility
13-Jan-2021,'0USAT,12-Jan-2021,600.00,,"-27,782.28",Airtime Purchase GTWORLD_QL-101CT0000000002289137209-2348038673032,SAVINGS ACCOUNT,GT_Bank,./static/raw/MR_IBRAHIM_ASHAFA_STATEMENT.pdf,Airtime Purchase GTWORLD_QL CT,Airtime Purchase GTWORLDQL CT,utility
13-Jan-2021,'0,12-Jan-2021,100.00,,"-27,882.28",STAMP DUTY CHARGE 12012021 STAMP DUTY CHARGE - 12/01/2021,SAVINGS ACCOUNT,GT_Bank,./static/raw/MR_IBRAHIM_ASHAFA_STATEMENT.pdf,STAMP DUTY CHARGE STAMP DUTY CHARGE,STAMP DUTY CHARGE STAMP DUTY CHARGE,bank_charges
15-Jan-2021,'0NIPT,15-Jan-2021,,"2,000.00","-25,882.28",TRANSFER BETWEEN CUSTOMERS 000010210115181058111404828359|REF62421503 4 BO abdullahi ibrahim IFO ASHAFA IBRA|624215034||abdullahi ibrahim REF:000010210115181058111404828359,SAVINGS ACCOUNT,GT_Bank,./static/raw/MR_IBRAHIM_ASHAFA_STATEMENT.pdf,TRANSFER BETWEEN CUSTOMERS REF BO abdullahi ibrahim IFO ASHAFA IBRA abdullahi ibrahim REF,TRANSFER BETWEEN CUSTOMERS REF BO abdullahi ibrahim IFO ASHAFA IBRA abdullahi ibrahim REF,transfert
15-Jan-2021,'99993134409999,15-Jan-2021,"2,000.00",,"-27,882.28",CASH WITHDRAWAL FROM OTHER ATM  - 313440- -691570-EBN000000000121 ENG WU FCT NG,SAVINGS ACCOUNT,GT_Bank,./static/raw/MR_IBRAHIM_ASHAFA_STATEMENT.pdf,CASH WITHDRAWAL FROM OTHER ATM EBN ENG WU FCT NG,CASH WITHDRAWAL FROM OTHER ATM EBN ENG WU FCT NG,cash
29-Jan-2021,'41200012073,29-Jan-2021,"26,529.45",,"-54,411.73",MATURED LOAN INSTALLMENT,SAVINGS ACCOUNT,GT_Bank,./static/raw/MR_IBRAHIM_ASHAFA_STATEMENT.pdf,MATURED LOAN INSTALLMENT,MATURED LOAN INSTALLMENT,loan
31-Jan-2021,'0,31-Jan-2021,486.07,,"-54,897.80",INTEREST CAPITALISED,SAVINGS ACCOUNT,GT_Bank,./static/raw/MR_IBRAHIM_ASHAFA_STATEMENT.pdf,INTEREST CAPITALISED,INTEREST CAPITALISED,loan
01-Feb-2021,'0NIPT,01-Feb-2021,,"70,970.94","16,073.14",TRANSFER BETWEEN CUSTOMERS 000004210201083128200086992417|TUD IBG/UTO/NetC Jan Sal Ashafa|200086992417|| REF:000004210201083128200086992417,SAVINGS ACCOUNT,GT_Bank,./static/raw/MR_IBRAHIM_ASHAFA_STATEMENT.pdf,TRANSFER BETWEEN CUSTOMERS TUD IBG UTO NetC Jan Sal Ashafa REF,TRANSFER BETWEEN CUSTOMERS TUD IBG UTO NetC Jan Sal Ashafa REF,transfert
01-Feb-2021,'0NIPG,01-Feb-2021,"6,000.00",,"10,073.14",NIBSS Instant Payment Outward 000013210201085225000358568993 via GTWORLD  TO FCMB/ABDULLAHI ASHAFA /26.875/REF:GW6819765690000000600021020108 f,SAVINGS ACCOUNT,GT_Bank,./static/raw/MR_IBRAHIM_ASHAFA_STATEMENT.pdf,NIBSS Instant Payment Outward via GTWORLD TO FCMB ABDULLAHI ASHAFA REF GW f,NIBSS Instant Payment Outward via GTWORLD TO FCMB ABDULLAHI ASHAFA REF GW,transfert
01-Feb-2021,'0NIPG,01-Feb-2021,25.00,,"10,048.14",COMMISSION 000013210201085225000358568993 NIP TRANSFER COMMISSION FOR 000013210201085225000358568993 via GTWORLD  TO FCMB/ABDULLAHI ASHAFA ReF:GW681976569000000060002102010850,SAVINGS ACCOUNT,GT_Bank,./static/raw/MR_IBRAHIM_ASHAFA_STATEMENT.pdf,COMMISSION NIP TRANSFER COMMISSION FOR via GTWORLD TO FCMB ABDULLAHI ASHAFA ReF GW,COMMISSION NIP TRANSFER COMMISSION FOR via GTWORLD TO FCMB ABDULLAHI ASHAFA ReF GW,commission
01-Feb-2021,'0NIPG,01-Feb-2021,1.87,,"10,046.27",VALUE ADDED TAX 000013210201085225000358568993 VAT ON NIP TRANSFER FOR 000013210201085225000358568993 via GTWORLD  TO FCMB/ABDULLAHI ASHAFA ReF:GW681976569000000060002102010850,SAVINGS ACCOUNT,GT_Bank,./static/raw/MR_IBRAHIM_ASHAFA_STATEMENT.pdf,VALUE ADDED TAX VAT ON NIP TRANSFER FOR via GTWORLD TO FCMB ABDULLAHI ASHAFA ReF GW,VALUE ADDED TAX VAT ON NIP TRANSFER FOR via GTWORLD TO FCMB ABDULLAHI ASHAFA ReF GW,tax
01-Feb-2021,'0USAT,01-Feb-2021,500.00,,"9,546.27",Airtime Purchase GTWORLD_QL- 101CT0000000002334362153-2348030549818,SAVINGS ACCOUNT,GT_Bank,./static/raw/MR_IBRAHIM_ASHAFA_STATEMENT.pdf,Airtime Purchase GTWORLD_QL CT,Airtime Purchase GTWORLDQL CT,utility
01-Feb-2021,'0USAT,01-Feb-2021,400.00,,"9,146.27",Airtime Purchase GTWORLD_QL- 101CT0000000002334363390-2348168413945,SAVINGS ACCOUNT,GT_Bank,./static/raw/MR_IBRAHIM_ASHAFA_STATEMENT.pdf,Airtime Purchase GTWORLD_QL CT,Airtime Purchase GTWORLDQL CT,utility
01-Feb-2021,'0USAT,01-Feb-2021.1,"1,000.00",,"8,146.27",Airtime Purchase GTWORLD_QL- 101CT0000000002334364532-2348038673032,SAVINGS ACCOUNT,GT_Bank,./static/raw/MR_IBRAHIM_ASHAFA_STATEMENT.pdf,Airtime Purchase GTWORLD_QL CT,Airtime Purchase GTWORLDQL CT,utility
01-Feb-2021,'0NIPG,01-Feb-2021,"2,000.00",,"6,146.27",NIBSS Instant Payment Outward 000013210201091529000358606055 via GTWORLD  TO FCMB/UMAR AMINA MOHAMMED /10.75/REF:GW6819765690000000200021020109  f,SAVINGS ACCOUNT,GT_Bank,./static/raw/MR_IBRAHIM_ASHAFA_STATEMENT.pdf,NIBSS Instant Payment Outward via GTWORLD TO FCMB UMAR AMINA MOHAMMED REF GW f,NIBSS Instant Payment Outward via GTWORLD TO FCMB UMAR AMINA MOHAMMED REF GW,transfert
01-Feb-2021,'0NIPG,01-Feb-2021,10.00,,"6,136.27",COMMISSION 000013210201091529000358606055 NIP TRANSFER COMMISSION FOR 000013210201091529000358606055 via GTWORLD  TO FCMB/UMAR AMINA MOHAMMED ReF:GW681976569000000020002102010913,SAVINGS ACCOUNT,GT_Bank,./static/raw/MR_IBRAHIM_ASHAFA_STATEMENT.pdf,COMMISSION NIP TRANSFER COMMISSION FOR via GTWORLD TO FCMB UMAR AMINA MOHAMMED ReF GW,COMMISSION NIP TRANSFER COMMISSION FOR via GTWORLD TO FCMB UMAR AMINA MOHAMMED ReF GW,commission
01-Feb-2021,'0NIPG,01-Feb-2021,.75,,"6,135.52",VALUE ADDED TAX 000013210201091529000358606055 VAT ON NIP TRANSFER FOR 000013210201091529000358606055 via GTWORLD  TO FCMB/UMAR AMINA MOHAMMED ReF:GW681976569000000020002102010913,SAVINGS ACCOUNT,GT_Bank,./static/raw/MR_IBRAHIM_ASHAFA_STATEMENT.pdf,VALUE ADDED TAX VAT ON NIP TRANSFER FOR via GTWORLD TO FCMB UMAR AMINA MOHAMMED ReF GW,VALUE ADDED TAX VAT ON NIP TRANSFER FOR via GTWORLD TO FCMB UMAR AMINA MOHAMMED ReF GW,tax
01-Feb-2021,'0GWTR,01-Feb-2021,"2,500.00",,"3,635.52",TRANSFER BETWEEN CUSTOMERS Via GTWorld REF:681976569000000025002102011714  from ASHAFA IBRAHIM ABDULLAHI  to  ALIYU MUHAMMED AHMED,SAVINGS ACCOUNT,GT_Bank,./static/raw/MR_IBRAHIM_ASHAFA_STATEMENT.pdf,TRANSFER BETWEEN CUSTOMERS Via GTWorld REF from ASHAFA IBRAHIM ABDULLAHI to ALIYU MUHAMMED AHMED,TRANSFER BETWEEN CUSTOMERS Via GTWorld REF from ASHAFA IBRAHIM ABDULLAHI to ALIYU MUHAMMED AHMED,transfert
01-Feb-2021,'99998344999999,01-Feb-2021,"3,500.00",,135.52,POS/WEB PURCHASE TRANSACTION  -834499- - 143699-PAYCOM NIGERIA LIMIT   LA           LANG,SAVINGS ACCOUNT,GT_Bank,./static/raw/MR_IBRAHIM_ASHAFA_STATEMENT.pdf,POS WEB PURCHASE TRANSACTION PAYCOM NIGERIA LIMIT LA LANG,POS WEB PURCHASE TRANSACTION PAYCOM NIGERIA LIMIT LA LANG,utility
01-Feb-2021,'0,01-Feb-2021,50.00,,85.52,STAMP DUTY CHARGE 01022021 STAMP DUTY CHARGE - 01/02/2021,SAVINGS ACCOUNT,GT_Bank,./static/raw/MR_IBRAHIM_ASHAFA_STATEMENT.pdf,STAMP DUTY CHARGE STAMP DUTY CHARGE,STAMP DUTY CHARGE STAMP DUTY CHARGE,bank_charges
01-Feb-2021,'200,01-Feb-2021,24.60,,60.92,STANDING ORDER SMS ALERT VAT FOR 21DEC2020-21JAN2021,SAVINGS ACCOUNT,GT_Bank,./static/raw/MR_IBRAHIM_ASHAFA_STATEMENT.pdf,STANDING ORDER SMS ALERT VAT FOR DEC JAN,STANDING ORDER SMS ALERT VAT FOR DEC JAN,commission
02-Feb-2021,'0GAPS,02-Feb-2021,,"7,125.00","7,185.92",TRANSFER BETWEEN CUSTOMERS via GAPS com on Bako M 500K sales 107556557 0 from NETCONSTRUCT NIGERIA LIMITED to ASHAFA IBRAHIM ABDULLAHI REF: 0005628626107556557000000,SAVINGS ACCOUNT,GT_Bank,./static/raw/MR_IBRAHIM_ASHAFA_STATEMENT.pdf,TRANSFER BETWEEN CUSTOMERS via GAPS com on Bako M K sales from NETCONSTRUCT NIGERIA LIMITED to ASHAFA IBRAHIM ABDULLAHI REF,TRANSFER BETWEEN CUSTOMERS via GAPS com on BakoK sales from NETCONSTRUCT NIGERIA LIMITED to ASHAFA IBRAHIM ABDULLAHI REF,transfert
02-Feb-2021,'0NIPG,02-Feb-2021,"6,000.00",,"1,185.92",NIBSS Instant Payment Outward 000013210202153948000360956151 via GTWORLD  TO ACCESS/SALIHU JOHN MUSTAPHA /26.875/REF:GW6819765690000000600021020215 f,SAVINGS ACCOUNT,GT_Bank,./static/raw/MR_IBRAHIM_ASHAFA_STATEMENT.pdf,NIBSS Instant Payment Outward via GTWORLD TO ACCESS SALIHU JOHN MUSTAPHA REF GW f,NIBSS Instant Payment Outward via GTWORLD TO ACCESS SALIHU JOHN MUSTAPHA REF GW,transfert
02-Feb-2021,'0NIPG,02-Feb-2021.1,25.00,,"1,160.92",COMMISSION 000013210202153948000360956151 NIP TRANSFER COMMISSION FOR 000013210202153948000360956151 via GTWORLD  TO ACCESS/SALIHU JOHN MUSTAPHA ReF:GW681976569000000060002102021538,SAVINGS ACCOUNT,GT_Bank,./static/raw/MR_IBRAHIM_ASHAFA_STATEMENT.pdf,COMMISSION NIP TRANSFER COMMISSION FOR via GTWORLD TO ACCESS SALIHU JOHN MUSTAPHA ReF GW,COMMISSION NIP TRANSFER COMMISSION FOR via GTWORLD TO ACCESS SALIHU JOHN MUSTAPHA ReF GW,commission
02-Feb-2021,'0NIPG,02-Feb-2021,1.87,,"1,159.05",VALUE ADDED TAX 000013210202153948000360956151 VAT ON NIP TRANSFER FOR 000013210202153948000360956151 via GTWORLD  TO ACCESS/SALIHU JOHN MUSTAPHA ReF:GW681976569000000060002102021538,SAVINGS ACCOUNT,GT_Bank,./static/raw/MR_IBRAHIM_ASHAFA_STATEMENT.pdf,VALUE ADDED TAX VAT ON NIP TRANSFER FOR via GTWORLD TO ACCESS SALIHU JOHN MUSTAPHA ReF GW,VALUE ADDED TAX VAT ON NIP TRANSFER FOR via GTWORLD TO ACCESS SALIHU JOHN MUSTAPHA ReF GW,tax
02-Feb-2021,'0NIPG,02-Feb-2021,"1,000.00",,159.05,NIBSS Instant Payment Outward 000013210202205513000361517308 via GTWORLD Family TO ECO/ASHAFA IBRAHIM /10.75/REF:GW6819765690000000100021020220  f,SAVINGS ACCOUNT,GT_Bank,./static/raw/MR_IBRAHIM_ASHAFA_STATEMENT.pdf,NIBSS Instant Payment Outward via GTWORLD Family TO ECO ASHAFA IBRAHIM REF GW f,NIBSS Instant Payment Outward via GTWORLD Family TO ECO ASHAFA IBRAHIM REF GW,transfert
02-Feb-2021,'0NIPG,02-Feb-2021,10.00,,149.05,COMMISSION 000013210202205513000361517308 NIP TRANSFER COMMISSION FOR 000013210202205513000361517308 via GTWORLD Family TO ECO/ASHAFA IBRAHIM ReF:GW681976569000000010002102022053,SAVINGS ACCOUNT,GT_Bank,./static/raw/MR_IBRAHIM_ASHAFA_STATEMENT.pdf,COMMISSION NIP TRANSFER COMMISSION FOR via GTWORLD Family TO ECO ASHAFA IBRAHIM ReF GW,COMMISSION NIP TRANSFER COMMISSION FOR via GTWORLD Family TO ECO ASHAFA IBRAHIM ReF GW,commission
02-Feb-2021,'0NIPG,02-Feb-2021,.75,,148.30,VALUE ADDED TAX 000013210202205513000361517308 VAT ON NIP TRANSFER FOR 000013210202205513000361517308 via GTWORLD Family TO ECO/ASHAFA IBRAHIM ReF:GW681976569000000010002102022053,SAVINGS ACCOUNT,GT_Bank,./static/raw/MR_IBRAHIM_ASHAFA_STATEMENT.pdf,VALUE ADDED TAX VAT ON NIP TRANSFER FOR via GTWORLD Family TO ECO ASHAFA IBRAHIM ReF GW,VALUE ADDED TAX VAT ON NIP TRANSFER FOR via GTWORLD Family TO ECO ASHAFA IBRAHIM ReF GW,tax
03-Feb-2021,'0USGT,03-Feb-2021,,"100,000.00","100,148.30",TRANSFER BETWEEN CUSTOMERS Via USSD GTBank Transfer 000000003710373884681097656900001000002021 02031138  from DEMIDE ENEYAMIRE JEMILATU to  ASHAFA IBRAHIM ABDULLAHI,SAVINGS ACCOUNT,GT_Bank,./static/raw/MR_IBRAHIM_ASHAFA_STATEMENT.pdf,TRANSFER BETWEEN CUSTOMERS Via USSD GTBank Transfer from DEMIDE ENEYAMIRE JEMILATU to ASHAFA IBRAHIM ABDULLAHI,TRANSFER BETWEEN CUSTOMERS Via USSD GTBank Transfer from DEMIDE ENEYAMIRE JEMILATU to ASHAFA IBRAHIM ABDULLAHI,transfert
03-Feb-2021,'0NIPT,03-Feb-2021,,"150,000.00","250,148.30",TRANSFER BETWEEN CUSTOMERS 000014210203114046213308787949|NIP:00001421 0203114046004905736313::VNS :::020033:210203114046323688892027362556|0200 33:210203114046323688892027362556||DEMIDE ENEYAMREF:000014210203114046213308787949,SAVINGS ACCOUNT,GT_Bank,./static/raw/MR_IBRAHIM_ASHAFA_STATEMENT.pdf,TRANSFER BETWEEN CUSTOMERS NIP VNS DEMIDE ENEYAMREF,TRANSFER BETWEEN CUSTOMERS NIP VNS DEMIDE ENEYAMREF,transfert
03-Feb-2021,'99994361519999,03-Feb-2021.1,"90,100.00",,"160,048.30",POS/WEB PURCHASE TRANSACTION  -436151- - 385669-BEST BUY APPLIANCES    LA           LANG,SAVINGS ACCOUNT,GT_Bank,./static/raw/MR_IBRAHIM_ASHAFA_STATEMENT.pdf,POS WEB PURCHASE TRANSACTION BEST BUY APPLIANCES LA LANG,POS WEB PURCHASE TRANSACTION BEST BUY APPLIANCES LA LANG,utility
03-Feb-2021,'0NIPG,03-Feb-2021,"129,647.00",,"30,401.30",NIBSS Instant Payment Outward 000013210203145736000362537897 via GTWORLD Loan repayment TO FBN/LIBERTA LEASING LIMITED /53.75/REF:GW6819765690000012964721020314  f,SAVINGS ACCOUNT,GT_Bank,./static/raw/MR_IBRAHIM_ASHAFA_STATEMENT.pdf,NIBSS Instant Payment Outward via GTWORLD Loan repayment TO FBN LIBERTA LEASING LIMITED REF GW f,NIBSS Instant Payment Outward via GTWORLD Loan repayment TO FBN LIBERTA LEASING LIMITED REF GW,utility
03-Feb-2021,'0NIPG,03-Feb-2021,50.00,,"30,351.30",COMMISSION 000013210203145736000362537897 NIP TRANSFER COMMISSION FOR 000013210203145736000362537897 via GTWORLD Loan repayment TO FBN/LIBERTA LEASING LIMITED ReF:GW681976569000001296472102031455,SAVINGS ACCOUNT,GT_Bank,./static/raw/MR_IBRAHIM_ASHAFA_STATEMENT.pdf,COMMISSION NIP TRANSFER COMMISSION FOR via GTWORLD Loan repayment TO FBN LIBERTA LEASING LIMITED ReF GW,COMMISSION NIP TRANSFER COMMISSION FOR via GTWORLD Loan repayment TO FBN LIBERTA LEASING LIMITED ReF GW,commission
03-Feb-2021,'0NIPG,03-Feb-2021,3.75,,"30,347.55",VALUE ADDED TAX 000013210203145736000362537897 VAT ON NIP TRANSFER FOR 000013210203145736000362537897 via GTWORLD Loan repayment TO FBN/LIBERTA LEASING LIMITED ReF:GW681976569000001296472102031455,SAVINGS ACCOUNT,GT_Bank,./static/raw/MR_IBRAHIM_ASHAFA_STATEMENT.pdf,VALUE ADDED TAX VAT ON NIP TRANSFER FOR via GTWORLD Loan repayment TO FBN LIBERTA LEASING LIMITED ReF GW,VALUE ADDED TAX VAT ON NIP TRANSFER FOR via GTWORLD Loan repayment TO FBN LIBERTA LEASING LIMITED ReF GW,tax
03-Feb-2021,'0NIPG,03-Feb-2021,"9,000.00",,"21,347.55",NIBSS Instant Payment Outward 000013210203153536000362596866 via GTWORLD  TO UBA/YAKUBU USMAN /26.875/REF:GW6819765690000000900021020315 f,SAVINGS ACCOUNT,GT_Bank,./static/raw/MR_IBRAHIM_ASHAFA_STATEMENT.pdf,NIBSS Instant Payment Outward via GTWORLD TO UBA YAKUBU USMAN REF GW f,NIBSS Instant Payment Outward via GTWORLD TO UBA YAKUBU USMAN REF GW,transfert
03-Feb-2021,'0NIPG,03-Feb-2021,25.00,,"21,322.55",COMMISSION 000013210203153536000362596866 NIP TRANSFER COMMISSION FOR 000013210203153536000362596866 via GTWORLD  TO UBA/YAKUBU USMAN ReF:GW681976569000000090002102031533,SAVINGS ACCOUNT,GT_Bank,./static/raw/MR_IBRAHIM_ASHAFA_STATEMENT.pdf,COMMISSION NIP TRANSFER COMMISSION FOR via GTWORLD TO UBA YAKUBU USMAN ReF GW,COMMISSION NIP TRANSFER COMMISSION FOR via GTWORLD TO UBA YAKUBU USMAN ReF GW,commission
03-Feb-2021,'0NIPG,03-Feb-2021,1.87,,"21,320.68",VALUE ADDED TAX 000013210203153536000362596866 VAT ON NIP TRANSFER FOR 000013210203153536000362596866 via GTWORLD  TO UBA/YAKUBU USMAN ReF:GW681976569000000090002102031533,SAVINGS ACCOUNT,GT_Bank,./static/raw/MR_IBRAHIM_ASHAFA_STATEMENT.pdf,VALUE ADDED TAX VAT ON NIP TRANSFER FOR via GTWORLD TO UBA YAKUBU USMAN ReF GW,VALUE ADDED TAX VAT ON NIP TRANSFER FOR via GTWORLD TO UBA YAKUBU USMAN ReF GW,tax
03-Feb-2021,'99993744369999,03-Feb-2021,"10,000.00",,"11,320.68",CASH WITHDRAWAL FROM OTHER ATM  - 374436- -869076-SWTFCMBsnk             Abuja NG,SAVINGS ACCOUNT,GT_Bank,./static/raw/MR_IBRAHIM_ASHAFA_STATEMENT.pdf,CASH WITHDRAWAL FROM OTHER ATM SWTFCMBsnk Abuja NG,CASH WITHDRAWAL FROM OTHER ATM SWTFCMBsnk Abuja NG,cash
03-Feb-2021,'0NIPT,03-Feb-2021.1,,"50,000.00","61,320.68",TRANSFER BETWEEN CUSTOMERS 000015210203203422001470533624||ASHAFA IBRAHIM ABDULLAHI||ENEYAMIRE JEMILATU DEMIDE REF:000015210203203422001470533624,SAVINGS ACCOUNT,GT_Bank,./static/raw/MR_IBRAHIM_ASHAFA_STATEMENT.pdf,TRANSFER BETWEEN CUSTOMERS ASHAFA IBRAHIM ABDULLAHI ENEYAMIRE JEMILATU DEMIDE REF,TRANSFER BETWEEN CUSTOMERS ASHAFA IBRAHIM ABDULLAHI ENEYAMIRE JEMILATU DEMIDE REF,transfert
03-Feb-2021,'0,03-Feb-2021,150.00,,"61,170.68",STAMP DUTY CHARGE 03022021 STAMP DUTY CHARGE - 03/02/2021,SAVINGS ACCOUNT,GT_Bank,./static/raw/MR_IBRAHIM_ASHAFA_STATEMENT.pdf,STAMP DUTY CHARGE STAMP DUTY CHARGE,STAMP DUTY CHARGE STAMP DUTY CHARGE,bank_charges
03-Feb-2021,'190,03-Feb-2021,328.00,,"60,842.68",SMS ALERT CHARGE FOR 21DEC2020- 21JAN2021,SAVINGS ACCOUNT,GT_Bank,./static/raw/MR_IBRAHIM_ASHAFA_STATEMENT.pdf,SMS ALERT CHARGE FOR DEC JAN,SMS ALERT CHARGE FOR DEC JAN,loan
03-Feb-2021,'0NIPG,03-Feb-2021,"10,000.00",,"50,842.68",NIBSS Instant Payment Outward 000013210203225350000363281800 via GTWORLD  TO UBA/YAKUBU ASHAFA ABDULLAHI /26.875/REF:GW6819765690000001000021020322 f,SAVINGS ACCOUNT,GT_Bank,./static/raw/MR_IBRAHIM_ASHAFA_STATEMENT.pdf,NIBSS Instant Payment Outward via GTWORLD TO UBA YAKUBU ASHAFA ABDULLAHI REF GW f,NIBSS Instant Payment Outward via GTWORLD TO UBA YAKUBU ASHAFA ABDULLAHI REF GW,transfert
03-Feb-2021,'0NIPG,03-Feb-2021,25.00,,"50,817.68",COMMISSION 000013210203225350000363281800 NIP TRANSFER COMMISSION FOR 000013210203225350000363281800 via GTWORLD  TO UBA/YAKUBU ASHAFA ABDULLAHI ReF:GW681976569000000100002102032252,SAVINGS ACCOUNT,GT_Bank,./static/raw/MR_IBRAHIM_ASHAFA_STATEMENT.pdf,COMMISSION NIP TRANSFER COMMISSION FOR via GTWORLD TO UBA YAKUBU ASHAFA ABDULLAHI ReF GW,COMMISSION NIP TRANSFER COMMISSION FOR via GTWORLD TO UBA YAKUBU ASHAFA ABDULLAHI ReF GW,commission
03-Feb-2021,'0NIPG,03-Feb-2021,1.87,,"50,815.81",VALUE ADDED TAX 000013210203225350000363281800 VAT ON NIP TRANSFER FOR 000013210203225350000363281800 via GTWORLD  TO UBA/YAKUBU ASHAFA ABDULLAHI ReF:GW681976569000000100002102032252,SAVINGS ACCOUNT,GT_Bank,./static/raw/MR_IBRAHIM_ASHAFA_STATEMENT.pdf,VALUE ADDED TAX VAT ON NIP TRANSFER FOR via GTWORLD TO UBA YAKUBU ASHAFA ABDULLAHI ReF GW,VALUE ADDED TAX VAT ON NIP TRANSFER FOR via GTWORLD TO UBA YAKUBU ASHAFA ABDULLAHI ReF GW,tax
04-Feb-2021,'0NIPG,04-Feb-2021,"30,000.00",,"20,815.81",NIBSS Instant Payment Outward 000013210204074527000363429064 via GTWORLD Bills TO UBA/ALIYU HAUWA /26.875/REF:GW6819765690000003000021020407 f,SAVINGS ACCOUNT,GT_Bank,./static/raw/MR_IBRAHIM_ASHAFA_STATEMENT.pdf,NIBSS Instant Payment Outward via GTWORLD Bills TO UBA ALIYU HAUWA REF GW f,NIBSS Instant Payment Outward via GTWORLD Bills TO UBA ALIYU HAUWA REF GW,transfert
04-Feb-2021,'0NIPG,04-Feb-2021,25.00,,"20,790.81",COMMISSION 000013210204074527000363429064 NIP TRANSFER COMMISSION FOR 000013210204074527000363429064 via GTWORLD Bills TO UBA/ALIYU HAUWA ReF:GW681976569000000300002102040743,SAVINGS ACCOUNT,GT_Bank,./static/raw/MR_IBRAHIM_ASHAFA_STATEMENT.pdf,COMMISSION NIP TRANSFER COMMISSION FOR via GTWORLD Bills TO UBA ALIYU HAUWA ReF GW,COMMISSION NIP TRANSFER COMMISSION FOR via GTWORLD Bills TO UBA ALIYU HAUWA ReF GW,commission
04-Feb-2021,'0NIPG,04-Feb-2021.1,1.87,,"20,788.94",VALUE ADDED TAX 000013210204074527000363429064 VAT ON NIP TRANSFER FOR 000013210204074527000363429064 via GTWORLD Bills TO UBA/ALIYU HAUWA ReF:GW681976569000000300002102040743,SAVINGS ACCOUNT,GT_Bank,./static/raw/MR_IBRAHIM_ASHAFA_STATEMENT.pdf,VALUE ADDED TAX VAT ON NIP TRANSFER FOR via GTWORLD Bills TO UBA ALIYU HAUWA ReF GW,VALUE ADDED TAX VAT ON NIP TRANSFER FOR via GTWORLD Bills TO UBA ALIYU HAUWA ReF GW,tax
04-Feb-2021,'0NIPG,04-Feb-2021,"3,000.00",,"17,788.94",NIBSS Instant Payment Outward 000013210204153705000364244469 via GTWORLD  TO UBA/YUSUF HASSAN /10.75/REF:GW6819765690000000300021020415  f,SAVINGS ACCOUNT,GT_Bank,./static/raw/MR_IBRAHIM_ASHAFA_STATEMENT.pdf,NIBSS Instant Payment Outward via GTWORLD TO UBA YUSUF HASSAN REF GW f,NIBSS Instant Payment Outward via GTWORLD TO UBA YUSUF HASSAN REF GW,transfert
04-Feb-2021,'0NIPG,04-Feb-2021,10.00,,"17,778.94",COMMISSION 000013210204153705000364244469 NIP TRANSFER COMMISSION FOR 000013210204153705000364244469 via GTWORLD  TO UBA/YUSUF HASSAN ReF:GW681976569000000030002102041535,SAVINGS ACCOUNT,GT_Bank,./static/raw/MR_IBRAHIM_ASHAFA_STATEMENT.pdf,COMMISSION NIP TRANSFER COMMISSION FOR via GTWORLD TO UBA YUSUF HASSAN ReF GW,COMMISSION NIP TRANSFER COMMISSION FOR via GTWORLD TO UBA YUSUF HASSAN ReF GW,commission
04-Feb-2021,'0NIPG,04-Feb-2021,.75,,"17,778.19",VALUE ADDED TAX 000013210204153705000364244469 VAT ON NIP TRANSFER FOR 000013210204153705000364244469 via GTWORLD  TO UBA/YUSUF HASSAN ReF:GW681976569000000030002102041535,SAVINGS ACCOUNT,GT_Bank,./static/raw/MR_IBRAHIM_ASHAFA_STATEMENT.pdf,VALUE ADDED TAX VAT ON NIP TRANSFER FOR via GTWORLD TO UBA YUSUF HASSAN ReF GW,VALUE ADDED TAX VAT ON NIP TRANSFER FOR via GTWORLD TO UBA YUSUF HASSAN ReF GW,tax
04-Feb-2021,'0USAT,04-Feb-2021,600.00,,"17,178.19",Airtime Purchase GTWORLD- 101CT0000000002345276476-2348038673032,SAVINGS ACCOUNT,GT_Bank,./static/raw/MR_IBRAHIM_ASHAFA_STATEMENT.pdf,Airtime Purchase GTWORLD CT,Airtime Purchase GTWORLD CT,utility
04-Feb-2021,'0USAT,04-Feb-2021,"1,000.00",,"16,178.19",Airtime Purchase GTWORLD_QL- 101CT0000000002345692679-2348161589111,SAVINGS ACCOUNT,GT_Bank,./static/raw/MR_IBRAHIM_ASHAFA_STATEMENT.pdf,Airtime Purchase GTWORLD_QL CT,Airtime Purchase GTWORLDQL CT,utility
05-Feb-2021,'0GWTR,05-Feb-2021,"2,000.00",,"14,178.19","TRANSFER BETWEEN CUSTOMERS Via GTWorld Family   REF:681976569000000020002102051552 from ASHAFA IBRAHIM ABDULLAHI  to ABDULLATIF, ABDULMAJEED",SAVINGS ACCOUNT,GT_Bank,./static/raw/MR_IBRAHIM_ASHAFA_STATEMENT.pdf,TRANSFER BETWEEN CUSTOMERS Via GTWorld Family REF from ASHAFA IBRAHIM ABDULLAHI to ABDULLATIF ABDULMAJEED,TRANSFER BETWEEN CUSTOMERS Via GTWorld Family REF from ASHAFA IBRAHIM ABDULLAHI to ABDULLATIF ABDULMAJEED,transfert
05-Feb-2021,'0NIPG,05-Feb-2021,"4,000.00",,"10,178.19",NIBSS Instant Payment Outward 000013210205202332000366354383 via GTWORLD  TO UBA/YAKUBU ASHAFA ABDULLAHI /10.75/REF:GW6819765690000000400021020520  f,SAVINGS ACCOUNT,GT_Bank,./static/raw/MR_IBRAHIM_ASHAFA_STATEMENT.pdf,NIBSS Instant Payment Outward via GTWORLD TO UBA YAKUBU ASHAFA ABDULLAHI REF GW f,NIBSS Instant Payment Outward via GTWORLD TO UBA YAKUBU ASHAFA ABDULLAHI REF GW,transfert
05-Feb-2021,'0NIPG,05-Feb-2021,10.00,,"10,168.19",COMMISSION 000013210205202332000366354383 NIP TRANSFER COMMISSION FOR 000013210205202332000366354383 via GTWORLD  TO UBA/YAKUBU ASHAFAABDULLAHIReF:GW681976569000000040002102052021,SAVINGS ACCOUNT,GT_Bank,./static/raw/MR_IBRAHIM_ASHAFA_STATEMENT.pdf,COMMISSION NIP TRANSFER COMMISSION FOR via GTWORLD TO UBA YAKUBU ASHAFAABDULLAHIReF GW,COMMISSION NIP TRANSFER COMMISSION FOR via GTWORLD TO UBA YAKUBU ASHAFAABDULLAHIReF GW,commission
05-Feb-2021,'0NIPG,05-Feb-2021,.75,,"10,167.44",VALUE ADDED TAX000013210205202332000366354383 VAT ON NIPTRANSFER FOR000013210205202332000366354383 viaGTWORLD  TO UBA/YAKUBU ASHAFAABDULLAHIReF:GW681976569000000040002102052021,SAVINGS ACCOUNT,GT_Bank,./static/raw/MR_IBRAHIM_ASHAFA_STATEMENT.pdf,VALUE ADDED TAX VAT ON NIPTRANSFER FOR viaGTWORLD TO UBA YAKUBU ASHAFAABDULLAHIReF GW,VALUE ADDED TAX VAT ON NIPTRANSFER FOR via GTWORLD TO UBA YAKUBU ASHAFAABDULLAHIReF GW,tax
06-Feb-2021,'99990063999999,06-Feb-2021,"5,100.00",,"5,067.44",POS/WEB PURCHASE TRANSACTION  -006399- -998040-MIKRO SOFTWARE SOLUTLALANG,SAVINGS ACCOUNT,GT_Bank,./static/raw/MR_IBRAHIM_ASHAFA_STATEMENT.pdf,POS WEB PURCHASE TRANSACTION MIKRO SOFTWARE SOLUTLALANG,POS WEB PURCHASE TRANSACTION MIKRO SOFTWARE SOLUTLALANG,utility
08-Feb-2021,'0GAPS,08-Feb-2021,,"237,500.00","242,567.44",TRANSFER BETWEEN CUSTOMERS via GAPScom on Fatima M 10M sales 107886560 0 fromNETCONSTRUCT NIGERIA LIMITED to ASHAFAIBRAHIM ABDULLAHIREF: 0005628626107886560000000,SAVINGS ACCOUNT,GT_Bank,./static/raw/MR_IBRAHIM_ASHAFA_STATEMENT.pdf,TRANSFER BETWEEN CUSTOMERS via GAPScom on Fatima M M sales fromNETCONSTRUCT NIGERIA LIMITED to ASHAFAIBRAHIM ABDULLAHIREF,TRANSFER BETWEEN CUSTOMERS via GAPScom on FatimaM sales from NETCONSTRUCT NIGERIA LIMITED to ASHAFAIBRAHIM ABDULLAHIREF,transfert
08-Feb-2021,'0GAPS,08-Feb-2021,,"209,000.00","451,567.44",TRANSFER BETWEEN CUSTOMERS via GAPScom on Ayoade D 10M sales 107886557 0 fromNETCONSTRUCT NIGERIA LIMITED to ASHAFAIBRAHIM ABDULLAHIREF: 0005628626107886557000000,SAVINGS ACCOUNT,GT_Bank,./static/raw/MR_IBRAHIM_ASHAFA_STATEMENT.pdf,TRANSFER BETWEEN CUSTOMERS via GAPScom on Ayoade D M sales fromNETCONSTRUCT NIGERIA LIMITED to ASHAFAIBRAHIM ABDULLAHIREF,TRANSFER BETWEEN CUSTOMERS via GAPScom on AyoadeM sales from NETCONSTRUCT NIGERIA LIMITED to ASHAFAIBRAHIM ABDULLAHIREF,transfert
08-Feb-2021,'0GAPS,08-Feb-2021,,"27,363.80","478,931.24",TRANSFER BETWEEN CUSTOMERS via GAPScom on Ekene N 1M sales 107886556 0 fromNETCONSTRUCT NIGERIA LIMITED to ASHAFAIBRAHIM ABDULLAHIREF: 0005628626107886556000000,SAVINGS ACCOUNT,GT_Bank,./static/raw/MR_IBRAHIM_ASHAFA_STATEMENT.pdf,TRANSFER BETWEEN CUSTOMERS via GAPScom on Ekene N M sales fromNETCONSTRUCT NIGERIA LIMITED to ASHAFAIBRAHIM ABDULLAHIREF,TRANSFER BETWEEN CUSTOMERS via GAPScom on EkeneM sales from NETCONSTRUCT NIGERIA LIMITED to ASHAFAIBRAHIM ABDULLAHIREF,transfert
08-Feb-2021,'0NIPG,08-Feb-2021,"40,000.00",,"438,931.24",NIBSS Instant Payment Outward000013210208131926000369778449 viaGTWORLD  TO FBN/LIBERTA LEASING LIMITED/26.875/REF:GW6819765690000004000021020813f,SAVINGS ACCOUNT,GT_Bank,./static/raw/MR_IBRAHIM_ASHAFA_STATEMENT.pdf,NIBSS Instant Payment Outward viaGTWORLD TO FBN LIBERTA LEASING LIMITED REF GW f,NIBSS Instant Payment Outward via GTWORLD TO FBN LIBERTA LEASING LIMITED REF GW,transfert
08-Feb-2021,'0NIPG,08-Feb-2021,25.00,,"438,906.24",COMMISSION 000013210208131926000369778449NIP TRANSFER COMMISSION FOR000013210208131926000369778449 viaGTWORLD  TO FBN/LIBERTA LEASING LIMITEDReF:GW681976569000000400002102081317,SAVINGS ACCOUNT,GT_Bank,./static/raw/MR_IBRAHIM_ASHAFA_STATEMENT.pdf,COMMISSION NIP TRANSFER COMMISSION FOR viaGTWORLD TO FBN LIBERTA LEASING LIMITEDReF GW,COMMISSION NIP TRANSFER COMMISSION FOR via GTWORLD TO FBN LIBERTA LEASING LIMITEDReF GW,commission
08-Feb-2021,'0NIPG,08-Feb-2021,1.87,,"438,904.37",VALUE ADDED TAX000013210208131926000369778449 VAT ON NIP TRANSFER FOR 000013210208131926000369778449 via GTWORLD  TO FBN/LIBERTA LEASING LIMITED ReF:GW681976569000000400002102081317,SAVINGS ACCOUNT,GT_Bank,./static/raw/MR_IBRAHIM_ASHAFA_STATEMENT.pdf,VALUE ADDED TAX VAT ON NIP TRANSFER FOR via GTWORLD TO FBN LIBERTA LEASING LIMITED ReF GW,VALUE ADDED TAX VAT ON NIP TRANSFER FOR via GTWORLD TO FBN LIBERTA LEASING LIMITED ReF GW,tax
08-Feb-2021,'0NIPG,08-Feb-2021,"13,000.00",,"425,904.37",NIBSS Instant Payment Outward 000013210208132051000369781557 via GTWORLD  TO UBA/YUSUF HASSAN /26.875/REF:GW6819765690000001300021020813 f,SAVINGS ACCOUNT,GT_Bank,./static/raw/MR_IBRAHIM_ASHAFA_STATEMENT.pdf,NIBSS Instant Payment Outward via GTWORLD TO UBA YUSUF HASSAN REF GW f,NIBSS Instant Payment Outward via GTWORLD TO UBA YUSUF HASSAN REF GW,transfert
08-Feb-2021,'0NIPG,08-Feb-2021,25.00,,"425,879.37",COMMISSION 000013210208132051000369781557 NIP TRANSFER COMMISSION FOR 000013210208132051000369781557 via GTWORLD  TO UBA/YUSUF HASSAN ReF:GW681976569000000130002102081319,SAVINGS ACCOUNT,GT_Bank,./static/raw/MR_IBRAHIM_ASHAFA_STATEMENT.pdf,COMMISSION NIP TRANSFER COMMISSION FOR via GTWORLD TO UBA YUSUF HASSAN ReF GW,COMMISSION NIP TRANSFER COMMISSION FOR via GTWORLD TO UBA YUSUF HASSAN ReF GW,commission
08-Feb-2021,'0NIPG,08-Feb-2021,1.87,,"425,877.50",VALUE ADDED TAX 000013210208132051000369781557 VAT ON NIP TRANSFER FOR 000013210208132051000369781557 via GTWORLD  TO UBA/YUSUF HASSAN ReF:GW681976569000000130002102081319,SAVINGS ACCOUNT,GT_Bank,./static/raw/MR_IBRAHIM_ASHAFA_STATEMENT.pdf,VALUE ADDED TAX VAT ON NIP TRANSFER FOR via GTWORLD TO UBA YUSUF HASSAN ReF GW,VALUE ADDED TAX VAT ON NIP TRANSFER FOR via GTWORLD TO UBA YUSUF HASSAN ReF GW,tax
08-Feb-2021,'0NIPG,08-Feb-2021,"20,000.00",,"405,877.50",NIBSS Instant Payment Outward 000013210208132549000369788686 via GTWORLD  TO UBA/ALIYU HAUWA /26.875/REF:GW6819765690000002000021020813 f,SAVINGS ACCOUNT,GT_Bank,./static/raw/MR_IBRAHIM_ASHAFA_STATEMENT.pdf,NIBSS Instant Payment Outward via GTWORLD TO UBA ALIYU HAUWA REF GW f,NIBSS Instant Payment Outward via GTWORLD TO UBA ALIYU HAUWA REF GW,transfert
08-Feb-2021,'0NIPG,08-Feb-2021,25.00,,"405,852.50",COMMISSION 000013210208132549000369788686 NIP TRANSFER COMMISSION FOR 000013210208132549000369788686 via GTWORLD  TO UBA/ALIYU HAUWA ReF:GW681976569000000200002102081323,SAVINGS ACCOUNT,GT_Bank,./static/raw/MR_IBRAHIM_ASHAFA_STATEMENT.pdf,COMMISSION NIP TRANSFER COMMISSION FOR via GTWORLD TO UBA ALIYU HAUWA ReF GW,COMMISSION NIP TRANSFER COMMISSION FOR via GTWORLD TO UBA ALIYU HAUWA ReF GW,commission
08-Feb-2021,'0NIPG,08-Feb-2021,1.87,,"405,850.63",VALUE ADDED TAX 000013210208132549000369788686 VAT ON NIP TRANSFER FOR 000013210208132549000369788686 via GTWORLD  TO UBA/ALIYU HAUWA ReF:GW681976569000000200002102081323,SAVINGS ACCOUNT,GT_Bank,./static/raw/MR_IBRAHIM_ASHAFA_STATEMENT.pdf,VALUE ADDED TAX VAT ON NIP TRANSFER FOR via GTWORLD TO UBA ALIYU HAUWA ReF GW,VALUE ADDED TAX VAT ON NIP TRANSFER FOR via GTWORLD TO UBA ALIYU HAUWA ReF GW,tax
08-Feb-2021,'0GWTR,08-Feb-2021,"20,000.00",,"385,850.63","TRANSFER BETWEEN CUSTOMERS Via GTWorld REF:681976569000000200002102081344  fromASHAFA IBRAHIM ABDULLAHI  to  MUNDU HAUWA, MOHAMMED",SAVINGS ACCOUNT,GT_Bank,./static/raw/MR_IBRAHIM_ASHAFA_STATEMENT.pdf,TRANSFER BETWEEN CUSTOMERS Via GTWorld REF fromASHAFA IBRAHIM ABDULLAHI to MUNDU HAUWA MOHAMMED,TRANSFER BETWEEN CUSTOMERS Via GTWorld REF from ASHAFA IBRAHIM ABDULLAHI to MUNDU HAUWA MOHAMMED,transfert
08-Feb-2021,'99993515269999,08-Feb-2021,"20,000.00",,"365,850.63",CASH WITHDRAWAL FROM OTHER ATM  - 351526- -042707-1033063503503 MAKAMA A MAKAMA         NG,SAVINGS ACCOUNT,GT_Bank,./static/raw/MR_IBRAHIM_ASHAFA_STATEMENT.pdf,CASH WITHDRAWAL FROM OTHER ATM MAKAMA A MAKAMA NG,CASH WITHDRAWAL FROM OTHER ATM MAKAMAMAKAMA NG,cash
08-Feb-2021,'99993547829999,08-Feb-2021,"20,000.00",,"345,850.63",CASH WITHDRAWAL FROM OTHER ATM  - 354782- -044303-1033063503503 MAKAMA A MAKAMA         NG,SAVINGS ACCOUNT,GT_Bank,./static/raw/MR_IBRAHIM_ASHAFA_STATEMENT.pdf,CASH WITHDRAWAL FROM OTHER ATM MAKAMA A MAKAMA NG,CASH WITHDRAWAL FROM OTHER ATM MAKAMAMAKAMA NG,cash
08-Feb-2021,'99993581629999,08-Feb-2021,35.00,,"345,815.63",ATM WITHDRAWAL COMMISSION  -358162- - 046047-1033063503503 MAKAMA A MAKAMA NG,SAVINGS ACCOUNT,GT_Bank,./static/raw/MR_IBRAHIM_ASHAFA_STATEMENT.pdf,ATM WITHDRAWAL COMMISSION MAKAMA A MAKAMA NG,ATM WITHDRAWAL COMMISSION MAKAMAMAKAMA NG,utility
08-Feb-2021,'99993581629999,08-Feb-2021,"20,000.00",,"325,815.63",CASH WITHDRAWAL FROM OTHER ATM  - 358162- -046047-1033063503503 MAKAMA A MAKAMA         NG,SAVINGS ACCOUNT,GT_Bank,./static/raw/MR_IBRAHIM_ASHAFA_STATEMENT.pdf,CASH WITHDRAWAL FROM OTHER ATM MAKAMA A MAKAMA NG,CASH WITHDRAWAL FROM OTHER ATM MAKAMAMAKAMA NG,cash
08-Feb-2021,'99993618899999,08-Feb-2021,35.00,,"325,780.63",ATM WITHDRAWAL COMMISSION  -361889- - 047921-1033063503503 MAKAMA A MAKAMA NG,SAVINGS ACCOUNT,GT_Bank,./static/raw/MR_IBRAHIM_ASHAFA_STATEMENT.pdf,ATM WITHDRAWAL COMMISSION MAKAMA A MAKAMA NG,ATM WITHDRAWAL COMMISSION MAKAMAMAKAMA NG,utility
08-Feb-2021,'99993618899999,08-Feb-2021,"5,000.00",,"320,780.63",CASH WITHDRAWAL FROM OTHER ATM  - 361889- -047921-1033063503503 MAKAMA A MAKAMA         NG,SAVINGS ACCOUNT,GT_Bank,./static/raw/MR_IBRAHIM_ASHAFA_STATEMENT.pdf,CASH WITHDRAWAL FROM OTHER ATM MAKAMA A MAKAMA NG,CASH WITHDRAWAL FROM OTHER ATM MAKAMAMAKAMA NG,cash
08-Feb-2021,'0NIPG,08-Feb-2021,"220,000.00",,"100,780.63",NIBSS Instant Payment Outward 000013210208152932000369956523 via GTWORLD  TO TAJB/IBRAHIM ASHAFA /53.75/REF:GW6819765690000022000021020815  f,SAVINGS ACCOUNT,GT_Bank,./static/raw/MR_IBRAHIM_ASHAFA_STATEMENT.pdf,NIBSS Instant Payment Outward via GTWORLD TO TAJB IBRAHIM ASHAFA REF GW f,NIBSS Instant Payment Outward via GTWORLD TO TAJB IBRAHIM ASHAFA REF GW,transfert
08-Feb-2021,'0NIPG,08-Feb-2021,50.00,,"100,730.63",COMMISSION 000013210208152932000369956523 NIP TRANSFER COMMISSION FOR 000013210208152932000369956523 via GTWORLD  TO TAJB/IBRAHIM ASHAFA ReF:GW681976569000002200002102081528,SAVINGS ACCOUNT,GT_Bank,./static/raw/MR_IBRAHIM_ASHAFA_STATEMENT.pdf,COMMISSION NIP TRANSFER COMMISSION FOR via GTWORLD TO TAJB IBRAHIM ASHAFA ReF GW,COMMISSION NIP TRANSFER COMMISSION FOR via GTWORLD TO TAJB IBRAHIM ASHAFA ReF GW,commission
08-Feb-2021,'0NIPG,08-Feb-2021,3.75,,"100,726.88",VALUE ADDED TAX 000013210208152932000369956523 VAT ON NIP TRANSFER FOR 000013210208152932000369956523 via GTWORLD  TO TAJB/IBRAHIM ASHAFA ReF:GW681976569000002200002102081528,SAVINGS ACCOUNT,GT_Bank,./static/raw/MR_IBRAHIM_ASHAFA_STATEMENT.pdf,VALUE ADDED TAX VAT ON NIP TRANSFER FOR via GTWORLD TO TAJB IBRAHIM ASHAFA ReF GW,VALUE ADDED TAX VAT ON NIP TRANSFER FOR via GTWORLD TO TAJB IBRAHIM ASHAFA ReF GW,tax
08-Feb-2021,'0GWTR,08-Feb-2021,"10,000.00",,"90,726.88","TRANSFER BETWEEN CUSTOMERS Via GTWorld REF:681976569000000100002102081532  fromASHAFA IBRAHIM ABDULLAHI  to  ABDULLATIF, RUKAYYA",SAVINGS ACCOUNT,GT_Bank,./static/raw/MR_IBRAHIM_ASHAFA_STATEMENT.pdf,TRANSFER BETWEEN CUSTOMERS Via GTWorld REF fromASHAFA IBRAHIM ABDULLAHI to ABDULLATIF RUKAYYA,TRANSFER BETWEEN CUSTOMERS Via GTWorld REF from ASHAFA IBRAHIM ABDULLAHI to ABDULLATIF RUKAYYA,transfert
08-Feb-2021,'0USAT,08-Feb-2021,400.00,,"90,326.88",Airtime Purchase GTWORLD- 101CT0000000002354886957-2348038673032,SAVINGS ACCOUNT,GT_Bank,./static/raw/MR_IBRAHIM_ASHAFA_STATEMENT.pdf,Airtime Purchase GTWORLD CT,Airtime Purchase GTWORLD CT,utility
08-Feb-2021,'0NIPG,08-Feb-2021,"10,000.00",,"80,326.88",NIBSS Instant Payment Outward 000013210208153754000369969428 via GTWORLD  TO UBA/ABDULRAZAK JIBRIN /26.875/REF:GW6819765690000001000021020815 f,SAVINGS ACCOUNT,GT_Bank,./static/raw/MR_IBRAHIM_ASHAFA_STATEMENT.pdf,NIBSS Instant Payment Outward via GTWORLD TO UBA ABDULRAZAK JIBRIN REF GW f,NIBSS Instant Payment Outward via GTWORLD TO UBA ABDULRAZAK JIBRIN REF GW,transfert
08-Feb-2021,'0NIPG,08-Feb-2021,25.00,,"80,301.88",COMMISSION 000013210208153754000369969428 NIP TRANSFER COMMISSION FOR 000013210208153754000369969428 via GTWORLD  TO UBA/ABDULRAZAK JIBRIN ReF:GW681976569000000100002102081536,SAVINGS ACCOUNT,GT_Bank,./static/raw/MR_IBRAHIM_ASHAFA_STATEMENT.pdf,COMMISSION NIP TRANSFER COMMISSION FOR via GTWORLD TO UBA ABDULRAZAK JIBRIN ReF GW,COMMISSION NIP TRANSFER COMMISSION FOR via GTWORLD TO UBA ABDULRAZAK JIBRIN ReF GW,commission
08-Feb-2021,'0NIPG,08-Feb-2021,1.87,,"80,300.01",VALUE ADDED TAX 000013210208153754000369969428 VAT ON NIP TRANSFER FOR 000013210208153754000369969428 via GTWORLD  TO UBA/ABDULRAZAK JIBRIN ReF:GW681976569000000100002102081536,SAVINGS ACCOUNT,GT_Bank,./static/raw/MR_IBRAHIM_ASHAFA_STATEMENT.pdf,VALUE ADDED TAX VAT ON NIP TRANSFER FOR via GTWORLD TO UBA ABDULRAZAK JIBRIN ReF GW,VALUE ADDED TAX VAT ON NIP TRANSFER FOR via GTWORLD TO UBA ABDULRAZAK JIBRIN ReF GW,tax
08-Feb-2021,'0,08-Feb-2021,150.00,,"80,150.01",STAMP DUTY CHARGE 08022021 STAMP DUTY CHARGE - 08/02/2021,SAVINGS ACCOUNT,GT_Bank,./static/raw/MR_IBRAHIM_ASHAFA_STATEMENT.pdf,STAMP DUTY CHARGE STAMP DUTY CHARGE,STAMP DUTY CHARGE STAMP DUTY CHARGE,bank_charges
09-Feb-2021,'99996142349999,09-Feb-2021,"10,000.00",,"70,150.01",POS/WEB PURCHASE TRANSACTION  -614234- - 441643-PAYARENA               LAGOS          NG,SAVINGS ACCOUNT,GT_Bank,./static/raw/MR_IBRAHIM_ASHAFA_STATEMENT.pdf,POS WEB PURCHASE TRANSACTION PAYARENA LAGOS NG,POS WEB PURCHASE TRANSACTION PAYARENA LAGOS NG,utility
09-Feb-2021,'0USAT,09-Feb-2021,"1,000.00",,"69,150.01",Airtime Purchase GTWORLD_QL- 101CT0000000002357792167-2348038673032,SAVINGS ACCOUNT,GT_Bank,./static/raw/MR_IBRAHIM_ASHAFA_STATEMENT.pdf,Airtime Purchase GTWORLD_QL CT,Airtime Purchase GTWORLDQL CT,utility
09-Feb-2021,'99994366519999,09-Feb-2021,35.00,,"69,115.01",ATM WITHDRAWAL COMMISSION  -436651- - 981095-KEYSTONE BANK          wuse           NG,SAVINGS ACCOUNT,GT_Bank,./static/raw/MR_IBRAHIM_ASHAFA_STATEMENT.pdf,ATM WITHDRAWAL COMMISSION KEYSTONE BANK wuse NG,ATM WITHDRAWAL COMMISSION KEYSTONE BANK wuse NG,utility
09-Feb-2021,'99994366519999,09-Feb-2021,"4,000.00",,"65,115.01",CASH WITHDRAWAL FROM OTHER ATM  - 436651- -981095-KEYSTONE BANK          wuse NG,SAVINGS ACCOUNT,GT_Bank,./static/raw/MR_IBRAHIM_ASHAFA_STATEMENT.pdf,CASH WITHDRAWAL FROM OTHER ATM KEYSTONE BANK wuse NG,CASH WITHDRAWAL FROM OTHER ATM KEYSTONE BANK wuse NG,cash
10-Feb-2021,'99991302979999,10-Feb-2021,"6,300.00",,"58,815.01",POS/WEB PURCHASE TRANSACTION  -130297- - 747302-SAHAD STORES LTD CBD   FC FCNG,SAVINGS ACCOUNT,GT_Bank,./static/raw/MR_IBRAHIM_ASHAFA_STATEMENT.pdf,POS WEB PURCHASE TRANSACTION SAHAD STORES LTD CBD FC FCNG,POS WEB PURCHASE TRANSACTION SAHAD STORES LTD CBD FC FCNG,utility
10-Feb-2021,'167410000,10-Feb-2021,"2,300.00",,"56,515.01",POS/WEB PURCHASE TRANSACTION  -016741- - 758746-SAHAD STORES LTD (POS RFC LANG,SAVINGS ACCOUNT,GT_Bank,./static/raw/MR_IBRAHIM_ASHAFA_STATEMENT.pdf,POS WEB PURCHASE TRANSACTION SAHAD STORES LTD POS RFC LANG,POS WEB PURCHASE TRANSACTION SAHAD STORES LTD POS RFC LANG,utility
10-Feb-2021,'99996923109999,10-Feb-2021.1,"1,600.00",,"54,915.01",POS/WEB PURCHASE TRANSACTION  -692310- - 122553-PAYCOM NIGERIA LIMIT   LA           LANG,SAVINGS ACCOUNT,GT_Bank,./static/raw/MR_IBRAHIM_ASHAFA_STATEMENT.pdf,POS WEB PURCHASE TRANSACTION PAYCOM NIGERIA LIMIT LA LANG,POS WEB PURCHASE TRANSACTION PAYCOM NIGERIA LIMIT LA LANG,utility
10-Feb-2021,'0USAT,10-Feb-2021,800.00,,"54,115.01",Airtime Purchase GTWORLD_QL- 101CT0000000002360796012-2348038673032,SAVINGS ACCOUNT,GT_Bank,./static/raw/MR_IBRAHIM_ASHAFA_STATEMENT.pdf,Airtime Purchase GTWORLD_QL CT,Airtime Purchase GTWORLDQL CT,utility
11-Feb-2021,'0NIPG,11-Feb-2021,"10,000.00",,"44,115.01",NIBSS Instant Payment Outward 000013210211164816000374631713 via GTWORLD  TO FCMB/AHMED MARYAM /26.875/REF:GW6819765690000001000021021116 f,SAVINGS ACCOUNT,GT_Bank,./static/raw/MR_IBRAHIM_ASHAFA_STATEMENT.pdf,NIBSS Instant Payment Outward via GTWORLD TO FCMB AHMED MARYAM REF GW f,NIBSS Instant Payment Outward via GTWORLD TO FCMB AHMED MARYAM REF GW,transfert
11-Feb-2021,'0NIPG,11-Feb-2021,25.00,,"44,090.01",COMMISSION 000013210211164816000374631713 NIP TRANSFER COMMISSION FOR 000013210211164816000374631713 via GTWORLD  TO FCMB/AHMED MARYAM ReF:GW681976569000000100002102111646,SAVINGS ACCOUNT,GT_Bank,./static/raw/MR_IBRAHIM_ASHAFA_STATEMENT.pdf,COMMISSION NIP TRANSFER COMMISSION FOR via GTWORLD TO FCMB AHMED MARYAM ReF GW,COMMISSION NIP TRANSFER COMMISSION FOR via GTWORLD TO FCMB AHMED MARYAM ReF GW,commission
11-Feb-2021,'0NIPG,11-Feb-2021,1.87,,"44,088.14",VALUE ADDED TAX 000013210211164816000374631713 VAT ON NIP TRANSFER FOR 000013210211164816000374631713 via GTWORLD  TO FCMB/AHMED MARYAM ReF:GW681976569000000100002102111646,SAVINGS ACCOUNT,GT_Bank,./static/raw/MR_IBRAHIM_ASHAFA_STATEMENT.pdf,VALUE ADDED TAX VAT ON NIP TRANSFER FOR via GTWORLD TO FCMB AHMED MARYAM ReF GW,VALUE ADDED TAX VAT ON NIP TRANSFER FOR via GTWORLD TO FCMB AHMED MARYAM ReF GW,tax
11-Feb-2021,'99999764869999,11-Feb-2021,35.00,,"44,053.14",ATM WITHDRAWAL COMMISSION  -976486- - 129698-000000000000738 New Wu Abuja          NG,SAVINGS ACCOUNT,GT_Bank,./static/raw/MR_IBRAHIM_ASHAFA_STATEMENT.pdf,ATM WITHDRAWAL COMMISSION New Wu Abuja NG,ATM WITHDRAWAL COMMISSION New Wu Abuja NG,utility
11-Feb-2021,'99999764869999,11-Feb-2021,"10,000.00",,"34,053.14",CASH WITHDRAWAL FROM OTHER ATM  - 976486- -129698-000000000000738 New Wu Abuja NG,SAVINGS ACCOUNT,GT_Bank,./static/raw/MR_IBRAHIM_ASHAFA_STATEMENT.pdf,CASH WITHDRAWAL FROM OTHER ATM New Wu Abuja NG,CASH WITHDRAWAL FROM OTHER ATM New Wu Abuja NG,cash
11-Feb-2021,'99999794299999,11-Feb-2021,35.00,,"34,018.14",ATM WITHDRAWAL COMMISSION  -979429- - 131126-000000000000738 New Wu Abuja          NG,SAVINGS ACCOUNT,GT_Bank,./static/raw/MR_IBRAHIM_ASHAFA_STATEMENT.pdf,ATM WITHDRAWAL COMMISSION New Wu Abuja NG,ATM WITHDRAWAL COMMISSION New Wu Abuja NG,utility
11-Feb-2021,'99999794299999,11-Feb-2021,"10,000.00",,"24,018.14",CASH WITHDRAWAL FROM OTHER ATM  - 979429- -131126-000000000000738 New Wu Abuja NG,SAVINGS ACCOUNT,GT_Bank,./static/raw/MR_IBRAHIM_ASHAFA_STATEMENT.pdf,CASH WITHDRAWAL FROM OTHER ATM New Wu Abuja NG,CASH WITHDRAWAL FROM OTHER ATM New Wu Abuja NG,cash
12-Feb-2021,'0USAT,12-Feb-2021,900.00,,"23,118.14",Airtime Purchase GTWORLD_QL- 101CT0000000002363555524-2348038673032,SAVINGS ACCOUNT,GT_Bank,./static/raw/MR_IBRAHIM_ASHAFA_STATEMENT.pdf,Airtime Purchase GTWORLD_QL CT,Airtime Purchase GTWORLDQL CT,utility
14-Feb-2021,'0NIPG,14-Feb-2021,"2,000.00",,"21,118.14",NIBSS Instant Payment Outward 000013210214112805000000193798 via GTWORLD  TO UBA/MUHAMMAD ISMAIL RABO /10.75/REF:GW6819765690000000200021021411  f,SAVINGS ACCOUNT,GT_Bank,./static/raw/MR_IBRAHIM_ASHAFA_STATEMENT.pdf,NIBSS Instant Payment Outward via GTWORLD TO UBA MUHAMMAD ISMAIL RABO REF GW f,NIBSS Instant Payment Outward via GTWORLD TO UBA MUHAMMAD ISMAIL RABO REF GW,transfert
14-Feb-2021,'0NIPG,14-Feb-2021,10.00,,"21,108.14",COMMISSION 000013210214112805000000193798NIP TRANSFER COMMISSION FOR000013210214112805000000193798 viaGTWORLD  TO UBA/MUHAMMAD ISMAIL RABOReF:GW681976569000000020002102141126,SAVINGS ACCOUNT,GT_Bank,./static/raw/MR_IBRAHIM_ASHAFA_STATEMENT.pdf,COMMISSION NIP TRANSFER COMMISSION FOR viaGTWORLD TO UBA MUHAMMAD ISMAIL RABOReF GW,COMMISSION NIP TRANSFER COMMISSION FOR via GTWORLD TO UBA MUHAMMAD ISMAIL RABOReF GW,commission
14-Feb-2021,'0NIPG,14-Feb-2021,.75,,"21,107.39",VALUE ADDED TAX000013210214112805000000193798 VAT ON NIPTRANSFER FOR000013210214112805000000193798 viaGTWORLD  TO UBA/MUHAMMAD ISMAIL RABOReF:GW681976569000000020002102141126,SAVINGS ACCOUNT,GT_Bank,./static/raw/MR_IBRAHIM_ASHAFA_STATEMENT.pdf,VALUE ADDED TAX VAT ON NIPTRANSFER FOR viaGTWORLD TO UBA MUHAMMAD ISMAIL RABOReF GW,VALUE ADDED TAX VAT ON NIPTRANSFER FOR via GTWORLD TO UBA MUHAMMAD ISMAIL RABOReF GW,tax
14-Feb-2021,'0USAT,14-Feb-2021,900.00,,"20,207.39",Airtime Purchase GTWORLD-101CT0000000002368803270-2348038673032,SAVINGS ACCOUNT,GT_Bank,./static/raw/MR_IBRAHIM_ASHAFA_STATEMENT.pdf,Airtime Purchase GTWORLD CT,Airtime Purchase GTWORLD CT,utility
14-Feb-2021,'0NIPG,14-Feb-2021,"3,000.00",,"17,207.39",NIBSS Instant Payment Outward000013210214184835000000624186 viaGTWORLD  TO UBA/OGAR PRISCA E/10.75/REF:GW6819765690000000300021021418  f,SAVINGS ACCOUNT,GT_Bank,./static/raw/MR_IBRAHIM_ASHAFA_STATEMENT.pdf,NIBSS Instant Payment Outward viaGTWORLD TO UBA OGAR PRISCA E REF GW f,NIBSS Instant Payment Outward via GTWORLD TO UBA OGAR PRISCAREF GW,transfert
14-Feb-2021,'0NIPG,14-Feb-2021,10.00,,"17,197.39",COMMISSION 000013210214184835000000624186NIP TRANSFER COMMISSION FOR000013210214184835000000624186 viaGTWORLD  TO UBA/OGAR PRISCA EReF:GW681976569000000030002102141847,SAVINGS ACCOUNT,GT_Bank,./static/raw/MR_IBRAHIM_ASHAFA_STATEMENT.pdf,COMMISSION NIP TRANSFER COMMISSION FOR viaGTWORLD TO UBA OGAR PRISCA EReF GW,COMMISSION NIP TRANSFER COMMISSION FOR via GTWORLD TO UBA OGAR PRISCA EReF GW,commission
14-Feb-2021,'0NIPG,14-Feb-2021,.75,,"17,196.64",VALUE ADDED TAX000013210214184835000000624186 VAT ON NIPTRANSFER FOR000013210214184835000000624186 viaGTWORLD  TO UBA/OGAR PRISCA EReF:GW681976569000000030002102141847,SAVINGS ACCOUNT,GT_Bank,./static/raw/MR_IBRAHIM_ASHAFA_STATEMENT.pdf,VALUE ADDED TAX VAT ON NIPTRANSFER FOR viaGTWORLD TO UBA OGAR PRISCA EReF GW,VALUE ADDED TAX VAT ON NIPTRANSFER FOR via GTWORLD TO UBA OGAR PRISCA EReF GW,tax
14-Feb-2021,'0NIPT,14-Feb-2021,,"20,000.00","37,196.64",TRANSFER BETWEEN CUSTOMERS000004210214193708001007402161|MB/UTO/1007402161/2348038509995/Trf to0131934493|2348038509995/1007402161||ABDULLAHI ASHAFAREF:000004210214193708001007402161,SAVINGS ACCOUNT,GT_Bank,./static/raw/MR_IBRAHIM_ASHAFA_STATEMENT.pdf,TRANSFER BETWEEN CUSTOMERS MB UTO Trf to ABDULLAHI ASHAFAREF,TRANSFER BETWEEN CUSTOMERS MB UTO Trf to ABDULLAHI ASHAFAREF,transfert
14-Feb-2021,'0GWTR,14-Feb-2021,"20,000.00",,"17,196.64","TRANSFER BETWEEN CUSTOMERS Via GTWorldREF:681976569000000200002102141940  fromASHAFA IBRAHIM ABDULLAHI  to  SALAMI,ABUBAKAR",SAVINGS ACCOUNT,GT_Bank,./static/raw/MR_IBRAHIM_ASHAFA_STATEMENT.pdf,TRANSFER BETWEEN CUSTOMERS Via GTWorldREF fromASHAFA IBRAHIM ABDULLAHI to SALAMI ABUBAKAR,TRANSFER BETWEEN CUSTOMERS Via GTWorldREF from ASHAFA IBRAHIM ABDULLAHI to SALAMI ABUBAKAR,transfert
14-Feb-2021,'0,14-Feb-2021,50.00,,"17,146.64",STAMP DUTY CHARGE 14022021 STAMP DUTYCHARGE - 14/02/2021,SAVINGS ACCOUNT,GT_Bank,./static/raw/MR_IBRAHIM_ASHAFA_STATEMENT.pdf,STAMP DUTY CHARGE STAMP DUTYCHARGE,STAMP DUTY CHARGE STAMP DUTYCHARGE,bank_charges
15-Feb-2021,'0USAT,15-Feb-2021,700.00,,"16,446.64",Airtime Purchase GTWORLD_QL- 101CT0000000002370753218-2348030549818,SAVINGS ACCOUNT,GT_Bank,./static/raw/MR_IBRAHIM_ASHAFA_STATEMENT.pdf,Airtime Purchase GTWORLD_QL CT,Airtime Purchase GTWORLDQL CT,utility
15-Feb-2021,'0USAT,15-Feb-2021,300.00,,"16,146.64",Airtime Purchase GTWORLD_QL- 101CT0000000002370754560-2348038673032,SAVINGS ACCOUNT,GT_Bank,./static/raw/MR_IBRAHIM_ASHAFA_STATEMENT.pdf,Airtime Purchase GTWORLD_QL CT,Airtime Purchase GTWORLDQL CT,utility
15-Feb-2021,'314930000,15-Feb-2021,"6,000.00",,"10,146.64",POS/WEB PURCHASE TRANSACTION  -031493- - 385734-SHEMA PETROLEUM LIMI   KD KDNG,SAVINGS ACCOUNT,GT_Bank,./static/raw/MR_IBRAHIM_ASHAFA_STATEMENT.pdf,POS WEB PURCHASE TRANSACTION SHEMA PETROLEUM LIMI KD KDNG,POS WEB PURCHASE TRANSACTION SHEMA PETROLEUM LIMI KD KDNG,utility
16-Feb-2021,'0NIPG,16-Feb-2021,"2,000.00",,"8,146.64",NIBSS Instant Payment Outward 000013210216075022000001924551 via GTWORLD  TO UBA/YAKUBU ASHAFA ABDULLAHI /10.75/REF:GW6819765690000000200021021607  f,SAVINGS ACCOUNT,GT_Bank,./static/raw/MR_IBRAHIM_ASHAFA_STATEMENT.pdf,NIBSS Instant Payment Outward via GTWORLD TO UBA YAKUBU ASHAFA ABDULLAHI REF GW f,NIBSS Instant Payment Outward via GTWORLD TO UBA YAKUBU ASHAFA ABDULLAHI REF GW,transfert
16-Feb-2021,'0NIPG,16-Feb-2021,10.00,,"8,136.64",COMMISSION 000013210216075022000001924551 NIP TRANSFER COMMISSION FOR 000013210216075022000001924551 via GTWORLD  TO UBA/YAKUBU ASHAFA ABDULLAHI ReF:GW681976569000000020002102160748,SAVINGS ACCOUNT,GT_Bank,./static/raw/MR_IBRAHIM_ASHAFA_STATEMENT.pdf,COMMISSION NIP TRANSFER COMMISSION FOR via GTWORLD TO UBA YAKUBU ASHAFA ABDULLAHI ReF GW,COMMISSION NIP TRANSFER COMMISSION FOR via GTWORLD TO UBA YAKUBU ASHAFA ABDULLAHI ReF GW,commission
16-Feb-2021,'0NIPG,16-Feb-2021,.75,,"8,135.89",VALUE ADDED TAX 000013210216075022000001924551 VAT ON NIP TRANSFER FOR 000013210216075022000001924551 via GTWORLD  TO UBA/YAKUBU ASHAFA ABDULLAHI ReF:GW681976569000000020002102160748,SAVINGS ACCOUNT,GT_Bank,./static/raw/MR_IBRAHIM_ASHAFA_STATEMENT.pdf,VALUE ADDED TAX VAT ON NIP TRANSFER FOR via GTWORLD TO UBA YAKUBU ASHAFA ABDULLAHI ReF GW,VALUE ADDED TAX VAT ON NIP TRANSFER FOR via GTWORLD TO UBA YAKUBU ASHAFA ABDULLAHI ReF GW,tax
16-Feb-2021,'0USAT,16-Feb-2021,700.00,,"7,435.89",Airtime Purchase GTWORLD_QL- 101CT0000000002373887314-2348038673032,SAVINGS ACCOUNT,GT_Bank,./static/raw/MR_IBRAHIM_ASHAFA_STATEMENT.pdf,Airtime Purchase GTWORLD_QL CT,Airtime Purchase GTWORLDQL CT,utility
16-Feb-2021,'0USAT,16-Feb-2021,300.00,,"7,135.89",Airtime Purchase GTWORLD_QL- 101CT0000000002373889775-2348037206680,SAVINGS ACCOUNT,GT_Bank,./static/raw/MR_IBRAHIM_ASHAFA_STATEMENT.pdf,Airtime Purchase GTWORLD_QL CT,Airtime Purchase GTWORLDQL CT,utility
16-Feb-2021,'99996306949999,16-Feb-2021,35.00,,"7,100.89",ATM WITHDRAWAL COMMISSION  -630694- - 270736-KEYSTONE BANK          wuse           NG,SAVINGS ACCOUNT,GT_Bank,./static/raw/MR_IBRAHIM_ASHAFA_STATEMENT.pdf,ATM WITHDRAWAL COMMISSION KEYSTONE BANK wuse NG,ATM WITHDRAWAL COMMISSION KEYSTONE BANK wuse NG,utility
16-Feb-2021,'99996306949999,16-Feb-2021,"3,000.00",,"4,100.89",CASH WITHDRAWAL FROM OTHER ATM  - 630694- -270736-KEYSTONE BANK          wuse NG,SAVINGS ACCOUNT,GT_Bank,./static/raw/MR_IBRAHIM_ASHAFA_STATEMENT.pdf,CASH WITHDRAWAL FROM OTHER ATM KEYSTONE BANK wuse NG,CASH WITHDRAWAL FROM OTHER ATM KEYSTONE BANK wuse NG,cash
16-Feb-2021,'99996307219999,16-Feb-2021,35.00,,"4,065.89",ATM WITHDRAWAL COMMISSION  -630721- - 272650-KEYSTONE BANK          WUSE 1         NG,SAVINGS ACCOUNT,GT_Bank,./static/raw/MR_IBRAHIM_ASHAFA_STATEMENT.pdf,ATM WITHDRAWAL COMMISSION KEYSTONE BANK WUSE NG,ATM WITHDRAWAL COMMISSION KEYSTONE BANK WUSE NG,utility
16-Feb-2021,'99996307219999,16-Feb-2021.1,"3,000.00",,"1,065.89",CASH WITHDRAWAL FROM OTHER ATM  - 630721- -272650-KEYSTONE BANK          WUSE 1 NG,SAVINGS ACCOUNT,GT_Bank,./static/raw/MR_IBRAHIM_ASHAFA_STATEMENT.pdf,CASH WITHDRAWAL FROM OTHER ATM KEYSTONE BANK WUSE NG,CASH WITHDRAWAL FROM OTHER ATM KEYSTONE BANK WUSE NG,cash
17-Feb-2021,'0USAT,17-Feb-2021,"1,000.00",,65.89,Airtime Purchase GTWORLD_QL- 101CT0000000002375735754-2348038673032,SAVINGS ACCOUNT,GT_Bank,./static/raw/MR_IBRAHIM_ASHAFA_STATEMENT.pdf,Airtime Purchase GTWORLD_QL CT,Airtime Purchase GTWORLDQL CT,utility
18-Feb-2021,'0NIPT,18-Feb-2021,,"5,000.00","5,065.89",TRANSFER BETWEEN CUSTOMERS 000004210218133931001013732644|USSD-NIP/To ASHAFA A./23480XXXX9995|2348038509995/1013732644||A BDULLAHI ASHAFA REF:000004210218133931001013732644,SAVINGS ACCOUNT,GT_Bank,./static/raw/MR_IBRAHIM_ASHAFA_STATEMENT.pdf,TRANSFER BETWEEN CUSTOMERS USSD NIP To ASHAFA A XXXX A BDULLAHI ASHAFA REF,TRANSFER BETWEEN CUSTOMERS USSD NIP To ASHAFAXXXXBDULLAHI ASHAFA REF,transfert
18-Feb-2021,'0USAT,18-Feb-2021,"1,000.00",,"4,065.89",Airtime Purchase GTWORLD_QL- 101CT0000000002379293154-2348038673032,SAVINGS ACCOUNT,GT_Bank,./static/raw/MR_IBRAHIM_ASHAFA_STATEMENT.pdf,Airtime Purchase GTWORLD_QL CT,Airtime Purchase GTWORLDQL CT,utility
18-Feb-2021,'99990154309999,18-Feb-2021,"4,000.00",,65.89,POS/WEB PURCHASE TRANSACTION  -015430- - 072662-ASPIRE/IBB WAY/ABUJA   FC           FCNG,SAVINGS ACCOUNT,GT_Bank,./static/raw/MR_IBRAHIM_ASHAFA_STATEMENT.pdf,POS WEB PURCHASE TRANSACTION ASPIRE IBB WAY ABUJA FC FCNG,POS WEB PURCHASE TRANSACTION ASPIRE IBB WAY ABUJA FC FCNG,utility
19-Feb-2021,'0NIPT,19-Feb-2021,,"50,000.00","50,065.89",TRANSFER BETWEEN CUSTOMERS 000003210219122658000736605240|web:TB1c/trf.b y Ibrahim.J.Akuma/ASHAFA IBRAHIM ABDULLAHI|S63681029||NASARAWA MICROFINANCE BANK LTD REF:000003210219122658000736605240,SAVINGS ACCOUNT,GT_Bank,./static/raw/MR_IBRAHIM_ASHAFA_STATEMENT.pdf,TRANSFER BETWEEN CUSTOMERS web TB c trf b y Ibrahim J Akuma ASHAFA IBRAHIM ABDULLAHI S NASARAWA MICROFINANCE BANK LTD REF,TRANSFER BETWEEN CUSTOMERS web TBtrfy IbrahimAkuma ASHAFA IBRAHIM ABDULLAHINASARAWA MICROFINANCE BANK LTD REF,transfert
19-Feb-2021,'0GWTR,19-Feb-2021,"30,000.00",,"20,065.89","TRANSFER BETWEEN CUSTOMERS Via GTWorld REF:681976569000000300002102191237  from ASHAFA IBRAHIM ABDULLAHI  to  SALAMI, ABUBAKAR",SAVINGS ACCOUNT,GT_Bank,./static/raw/MR_IBRAHIM_ASHAFA_STATEMENT.pdf,TRANSFER BETWEEN CUSTOMERS Via GTWorld REF from ASHAFA IBRAHIM ABDULLAHI to SALAMI ABUBAKAR,TRANSFER BETWEEN CUSTOMERS Via GTWorld REF from ASHAFA IBRAHIM ABDULLAHI to SALAMI ABUBAKAR,transfert
19-Feb-2021,'0USAT,19-Feb-2021,900.00,,"19,165.89",Airtime Purchase GTWORLD_QL- 101CT0000000002381583888-2348038673032,SAVINGS ACCOUNT,GT_Bank,./static/raw/MR_IBRAHIM_ASHAFA_STATEMENT.pdf,Airtime Purchase GTWORLD_QL CT,Airtime Purchase GTWORLDQL CT,utility
19-Feb-2021,'0NIPG,19-Feb-2021,"2,000.00",,"17,165.89",NIBSS Instant Payment Outward 000013210219141042000006479351 via GTWORLD  TO MUHAMMAD ISMAIL RABO /10.75/REF:GW6819765690000000200021021914  f,SAVINGS ACCOUNT,GT_Bank,./static/raw/MR_IBRAHIM_ASHAFA_STATEMENT.pdf,NIBSS Instant Payment Outward via GTWORLD TO MUHAMMAD ISMAIL RABO REF GW f,NIBSS Instant Payment Outward via GTWORLD TO MUHAMMAD ISMAIL RABO REF GW,transfert
19-Feb-2021,'0NIPG,19-Feb-2021,10.00,,"17,155.89",COMMISSION 000013210219141042000006479351 NIP TRANSFER COMMISSION FOR 000013210219141042000006479351 via GTWORLD  TO MUHAMMAD ISMAIL RABO ReF:GW681976569000000020002102191409,SAVINGS ACCOUNT,GT_Bank,./static/raw/MR_IBRAHIM_ASHAFA_STATEMENT.pdf,COMMISSION NIP TRANSFER COMMISSION FOR via GTWORLD TO MUHAMMAD ISMAIL RABO ReF GW,COMMISSION NIP TRANSFER COMMISSION FOR via GTWORLD TO MUHAMMAD ISMAIL RABO ReF GW,commission
19-Feb-2021,'0NIPG,19-Feb-2021,.75,,"17,155.14",VALUE ADDED TAX000013210219141042000006479351 VAT ON NIPTRANSFER FOR000013210219141042000006479351 viaGTWORLD  TO MUHAMMAD ISMAIL RABOReF:GW681976569000000020002102191409,SAVINGS ACCOUNT,GT_Bank,./static/raw/MR_IBRAHIM_ASHAFA_STATEMENT.pdf,VALUE ADDED TAX VAT ON NIPTRANSFER FOR viaGTWORLD TO MUHAMMAD ISMAIL RABOReF GW,VALUE ADDED TAX VAT ON NIPTRANSFER FOR via GTWORLD TO MUHAMMAD ISMAIL RABOReF GW,tax
19-Feb-2021,'99998000799999,19-Feb-2021,"7,000.00",,"10,155.14",POS/WEB PURCHASE TRANSACTION  -800079- -573808-SAMAO VENTURES LIMITLALANG,SAVINGS ACCOUNT,GT_Bank,./static/raw/MR_IBRAHIM_ASHAFA_STATEMENT.pdf,POS WEB PURCHASE TRANSACTION SAMAO VENTURES LIMITLALANG,POS WEB PURCHASE TRANSACTION SAMAO VENTURES LIMITLALANG,utility
19-Feb-2021,'0,19-Feb-2021,50.00,,"10,105.14",STAMP DUTY CHARGE 19022021 STAMP DUTYCHARGE - 19/02/2021,SAVINGS ACCOUNT,GT_Bank,./static/raw/MR_IBRAHIM_ASHAFA_STATEMENT.pdf,STAMP DUTY CHARGE STAMP DUTYCHARGE,STAMP DUTY CHARGE STAMP DUTYCHARGE,bank_charges
19-Feb-2021,'0NIPG,20-Feb-2021,"2,000.00",,"8,105.14",NIBSS Instant Payment Outward000013210219233055000007176139 viaGTWORLD  TO YAKUBU ASHAFA ABDULLAHI/10.75/REF:GW6819765690000000200021021923  f,SAVINGS ACCOUNT,GT_Bank,./static/raw/MR_IBRAHIM_ASHAFA_STATEMENT.pdf,NIBSS Instant Payment Outward viaGTWORLD TO YAKUBU ASHAFA ABDULLAHI REF GW f,NIBSS Instant Payment Outward via GTWORLD TO YAKUBU ASHAFA ABDULLAHI REF GW,transfert
19-Feb-2021,'0NIPG,20-Feb-2021,10.00,,"8,095.14",COMMISSION 000013210219233055000007176139NIP TRANSFER COMMISSION FOR000013210219233055000007176139 viaGTWORLD  TO YAKUBU ASHAFA ABDULLAHIReF:GW681976569000000020002102192329,SAVINGS ACCOUNT,GT_Bank,./static/raw/MR_IBRAHIM_ASHAFA_STATEMENT.pdf,COMMISSION NIP TRANSFER COMMISSION FOR viaGTWORLD TO YAKUBU ASHAFA ABDULLAHIReF GW,COMMISSION NIP TRANSFER COMMISSION FOR via GTWORLD TO YAKUBU ASHAFA ABDULLAHIReF GW,commission
19-Feb-2021,'0NIPG,20-Feb-2021,.75,,"8,094.39",VALUE ADDED TAX000013210219233055000007176139 VAT ON NIPTRANSFER FOR000013210219233055000007176139 viaGTWORLD  TO YAKUBU ASHAFA ABDULLAHIReF:GW681976569000000020002102192329,SAVINGS ACCOUNT,GT_Bank,./static/raw/MR_IBRAHIM_ASHAFA_STATEMENT.pdf,VALUE ADDED TAX VAT ON NIPTRANSFER FOR viaGTWORLD TO YAKUBU ASHAFA ABDULLAHIReF GW,VALUE ADDED TAX VAT ON NIPTRANSFER FOR via GTWORLD TO YAKUBU ASHAFA ABDULLAHIReF GW,tax
20-Feb-2021,'0USAT,20-Feb-2021,900.00,,"7,194.39",Airtime Purchase GTWORLD-101CT0000000002382890029-2348038673032,SAVINGS ACCOUNT,GT_Bank,./static/raw/MR_IBRAHIM_ASHAFA_STATEMENT.pdf,Airtime Purchase GTWORLD CT,Airtime Purchase GTWORLD CT,utility
21-Feb-2021,'0GWTR,21-Feb-2021,"2,000.00",,"5,194.39","TRANSFER BETWEEN CUSTOMERS Via GTWorldREF:681976569000000020002102210711  fromASHAFA IBRAHIM ABDULLAHI  to  YOGH,BRENDAMIMI",SAVINGS ACCOUNT,GT_Bank,./static/raw/MR_IBRAHIM_ASHAFA_STATEMENT.pdf,TRANSFER BETWEEN CUSTOMERS Via GTWorldREF fromASHAFA IBRAHIM ABDULLAHI to YOGH BRENDAMIMI,TRANSFER BETWEEN CUSTOMERS Via GTWorldREF from ASHAFA IBRAHIM ABDULLAHI to YOGH BRENDAMIMI,transfert
21-Feb-2021,'99993132189999,21-Feb-2021,"3,500.00",,"1,694.39",POS/WEB PURCHASE TRANSACTION  -313218- -264606-GARKI 2 POS FOR DOMILALANG,SAVINGS ACCOUNT,GT_Bank,./static/raw/MR_IBRAHIM_ASHAFA_STATEMENT.pdf,POS WEB PURCHASE TRANSACTION GARKI POS FOR DOMILALANG,POS WEB PURCHASE TRANSACTION GARKI POS FOR DOMILALANG,utility
21-Feb-2021,'99993390429999,21-Feb-2021,"1,250.00",,444.39,POS/WEB PURCHASE TRANSACTION  -339042- -040157-CITYMART BAKERY & COFCFCNG,SAVINGS ACCOUNT,GT_Bank,./static/raw/MR_IBRAHIM_ASHAFA_STATEMENT.pdf,POS WEB PURCHASE TRANSACTION CITYMART BAKERY COFCFCNG,POS WEB PURCHASE TRANSACTION CITYMART BAKERY COFCFCNG,utility
21-Feb-2021,'0NIPT,21-Feb-2021,,"5,000.00","5,444.39",TRANSFER BETWEEN CUSTOMERS000015210221194205001510872617|Wawis|347848893||JIBRIN UMAR ABUHURAIRAREF:000015210221194205001510872617,SAVINGS ACCOUNT,GT_Bank,./static/raw/MR_IBRAHIM_ASHAFA_STATEMENT.pdf,TRANSFER BETWEEN CUSTOMERS Wawis JIBRIN UMAR ABUHURAIRAREF,TRANSFER BETWEEN CUSTOMERS Wawis JIBRIN UMAR ABUHURAIRAREF,transfert
21-Feb-2021,'9954110000,21-Feb-2021,"5,000.00",,444.39,POS/WEB PURCHASE TRANSACTION  -995411- -476935-SHEMA PETROLEUM LIMIKDKDNG,SAVINGS ACCOUNT,GT_Bank,./static/raw/MR_IBRAHIM_ASHAFA_STATEMENT.pdf,POS WEB PURCHASE TRANSACTION SHEMA PETROLEUM LIMIKDKDNG,POS WEB PURCHASE TRANSACTION SHEMA PETROLEUM LIMIKDKDNG,utility
21-Feb-2021,'0USAT,21-Feb-2021,400.00,,44.39,Airtime Purchase GTWORLD_QL-101CT0000000002387257495-2348038673032,SAVINGS ACCOUNT,GT_Bank,./static/raw/MR_IBRAHIM_ASHAFA_STATEMENT.pdf,Airtime Purchase GTWORLD_QL CT,Airtime Purchase GTWORLDQL CT,utility
22-Feb-2021,'0GAPS,22-Feb-2021,,"579,500.00","579,544.39",TRANSFER BETWEEN CUSTOMERS via GAPScom on Enemali 18.8M sales 108374531 0 fromNETCONSTRUCT NIGERIA LIMITED to ASHAFAIBRAHIM ABDULLAHIREF: 0005628626108374531000000,SAVINGS ACCOUNT,GT_Bank,./static/raw/MR_IBRAHIM_ASHAFA_STATEMENT.pdf,TRANSFER BETWEEN CUSTOMERS via GAPScom on Enemali M sales fromNETCONSTRUCT NIGERIA LIMITED to ASHAFAIBRAHIM ABDULLAHIREF,TRANSFER BETWEEN CUSTOMERS via GAPScom on Enemalisales from NETCONSTRUCT NIGERIA LIMITED to ASHAFAIBRAHIM ABDULLAHIREF,transfert
22-Feb-2021,'0NIPG,22-Feb-2021,"5,000.00",,"574,544.39",FAILED NIBSS INSTANT PAYMENT000013210222154324000010114068 viaGTWORLD  TO ZBN/JIBRIN UMAR ABUHURAIRA/10.75/REF:GW6819765690000000500021022215  f,SAVINGS ACCOUNT,GT_Bank,./static/raw/MR_IBRAHIM_ASHAFA_STATEMENT.pdf,FAILED NIBSS INSTANT PAYMENT viaGTWORLD TO ZBN JIBRIN UMAR ABUHURAIRA REF GW f,FAILED NIBSS INSTANT PAYMENT via GTWORLD TO ZBN JIBRIN UMAR ABUHURAIRA REF GW,transfert
22-Feb-2021,'0NIPG,22-Feb-2021,10.00,,"574,534.39",COMMISSION 000013210222154324000010114068NIP TRANSFER COMMISSION FOR000013210222154324000010114068 viaGTWORLD  TO ZBN/JIBRIN UMAR ABUHURAIRAReF:GW681976569000000050002102221541,SAVINGS ACCOUNT,GT_Bank,./static/raw/MR_IBRAHIM_ASHAFA_STATEMENT.pdf,COMMISSION NIP TRANSFER COMMISSION FOR viaGTWORLD TO ZBN JIBRIN UMAR ABUHURAIRAReF GW,COMMISSION NIP TRANSFER COMMISSION FOR via GTWORLD TO ZBN JIBRIN UMAR ABUHURAIRAReF GW,commission
22-Feb-2021,'0NIPG,22-Feb-2021,.75,,"574,533.64",VALUE ADDED TAX000013210222154324000010114068 VAT ON NIPTRANSFER FOR000013210222154324000010114068 viaGTWORLD  TO ZBN/JIBRIN UMAR ABUHURAIRAReF:GW681976569000000050002102221541,SAVINGS ACCOUNT,GT_Bank,./static/raw/MR_IBRAHIM_ASHAFA_STATEMENT.pdf,VALUE ADDED TAX VAT ON NIPTRANSFER FOR viaGTWORLD TO ZBN JIBRIN UMAR ABUHURAIRAReF GW,VALUE ADDED TAX VAT ON NIPTRANSFER FOR via GTWORLD TO ZBN JIBRIN UMAR ABUHURAIRAReF GW,tax
22-Feb-2021,'0NIPG,22-Feb-2021,"5,000.00",,"569,533.64",NIBSS Instant Payment Outward000013210222154407000010115113 viaGTWORLD  TO YUSUF HASSAN/10.75/REF:GW6819765690000000500021022215  f,SAVINGS ACCOUNT,GT_Bank,./static/raw/MR_IBRAHIM_ASHAFA_STATEMENT.pdf,NIBSS Instant Payment Outward viaGTWORLD TO YUSUF HASSAN REF GW f,NIBSS Instant Payment Outward via GTWORLD TO YUSUF HASSAN REF GW,transfert
22-Feb-2021,'0NIPG,22-Feb-2021,10.00,,"569,523.64",COMMISSION 000013210222154407000010115113NIP TRANSFER COMMISSION FOR000013210222154407000010115113 viaGTWORLD  TO YUSUF HASSANReF:GW681976569000000050002102221542,SAVINGS ACCOUNT,GT_Bank,./static/raw/MR_IBRAHIM_ASHAFA_STATEMENT.pdf,COMMISSION NIP TRANSFER COMMISSION FOR viaGTWORLD TO YUSUF HASSANReF GW,COMMISSION NIP TRANSFER COMMISSION FOR via GTWORLD TO YUSUF HASSANReF GW,commission
22-Feb-2021,'0NIPG,22-Feb-2021,.75,,"569,522.89",VALUE ADDED TAX000013210222154407000010115113 VAT ON NIPTRANSFER FOR000013210222154407000010115113 viaGTWORLD  TO YUSUF HASSANReF:GW681976569000000050002102221542,SAVINGS ACCOUNT,GT_Bank,./static/raw/MR_IBRAHIM_ASHAFA_STATEMENT.pdf,VALUE ADDED TAX VAT ON NIPTRANSFER FOR viaGTWORLD TO YUSUF HASSANReF GW,VALUE ADDED TAX VAT ON NIPTRANSFER FOR via GTWORLD TO YUSUF HASSANReF GW,tax
22-Feb-2021,'0NIPG,22-Feb-2021,"4,000.00",,"565,522.89",NIBSS Instant Payment Outward000013210222154703000010119633 viaGTWORLD  TO DALHATU ABDULLAHI ASHAFA/10.75/REF:GW6819765690000000400021022215  f,SAVINGS ACCOUNT,GT_Bank,./static/raw/MR_IBRAHIM_ASHAFA_STATEMENT.pdf,NIBSS Instant Payment Outward viaGTWORLD TO DALHATU ABDULLAHI ASHAFA REF GW f,NIBSS Instant Payment Outward via GTWORLD TO DALHATU ABDULLAHI ASHAFA REF GW,transfert
22-Feb-2021,'0NIPG,22-Feb-2021,10.00,,"565,512.89",COMMISSION 000013210222154703000010119633NIP TRANSFER COMMISSION FOR000013210222154703000010119633 viaGTWORLD  TO DALHATU ABDULLAHI ASHAFAReF:GW681976569000000040002102221545,SAVINGS ACCOUNT,GT_Bank,./static/raw/MR_IBRAHIM_ASHAFA_STATEMENT.pdf,COMMISSION NIP TRANSFER COMMISSION FOR viaGTWORLD TO DALHATU ABDULLAHI ASHAFAReF GW,COMMISSION NIP TRANSFER COMMISSION FOR via GTWORLD TO DALHATU ABDULLAHI ASHAFAReF GW,commission
22-Feb-2021,'0NIPG,22-Feb-2021,.75,,"565,512.14",VALUE ADDED TAX000013210222154703000010119633 VAT ON NIPTRANSFER FOR000013210222154703000010119633 viaGTWORLD  TO DALHATU ABDULLAHI ASHAFAReF:GW681976569000000040002102221545,SAVINGS ACCOUNT,GT_Bank,./static/raw/MR_IBRAHIM_ASHAFA_STATEMENT.pdf,VALUE ADDED TAX VAT ON NIPTRANSFER FOR viaGTWORLD TO DALHATU ABDULLAHI ASHAFAReF GW,VALUE ADDED TAX VAT ON NIPTRANSFER FOR via GTWORLD TO DALHATU ABDULLAHI ASHAFAReF GW,tax
22-Feb-2021,'0NIPR,22-Feb-2021,,"5,000.00","570,512.14",FAILED NIBSS INSTANT PAYMENT000013210222154324000010114068 NIP Reversal:Failure From Beneficiary BankREF:000013210222154324000010114068,SAVINGS ACCOUNT,GT_Bank,./static/raw/MR_IBRAHIM_ASHAFA_STATEMENT.pdf,FAILED NIBSS INSTANT PAYMENT NIP Reversal Failure From Beneficiary BankREF,FAILED NIBSS INSTANT PAYMENT NIP Reversal Failure From Beneficiary BankREF,reversal
22-Feb-2021,'00,22-Feb-2021,,10.00,"570,522.14",FAILED NIBSS INSTANT PAYMENT000013210222154324000010114068 NIP Reversal:Failure From Beneficiary BankREF:000013210222154324000010114068,SAVINGS ACCOUNT,GT_Bank,./static/raw/MR_IBRAHIM_ASHAFA_STATEMENT.pdf,FAILED NIBSS INSTANT PAYMENT NIP Reversal Failure From Beneficiary BankREF,FAILED NIBSS INSTANT PAYMENT NIP Reversal Failure From Beneficiary BankREF,reversal
22-Feb-2021,'00,22-Feb-2021,,.75,"570,522.89",FAILED NIBSS INSTANT PAYMENT000013210222154324000010114068 NIP Reversal:Failure From Beneficiary BankREF:000013210222154324000010114068,SAVINGS ACCOUNT,GT_Bank,./static/raw/MR_IBRAHIM_ASHAFA_STATEMENT.pdf,FAILED NIBSS INSTANT PAYMENT NIP Reversal Failure From Beneficiary BankREF,FAILED NIBSS INSTANT PAYMENT NIP Reversal Failure From Beneficiary BankREF,reversal
22-Feb-2021,'0NIPG,22-Feb-2021,"210,000.00",,"360,522.89",NIBSS Instant Payment Outward000013210222160431000010147525 viaGTWORLD  TO IBRAHIM ASHAFA/53.75/REF:GW6819765690000021000021022216  f,SAVINGS ACCOUNT,GT_Bank,./static/raw/MR_IBRAHIM_ASHAFA_STATEMENT.pdf,NIBSS Instant Payment Outward viaGTWORLD TO IBRAHIM ASHAFA REF GW f,NIBSS Instant Payment Outward via GTWORLD TO IBRAHIM ASHAFA REF GW,transfert
22-Feb-2021,'0NIPG,22-Feb-2021,50.00,,"360,472.89",COMMISSION 000013210222160431000010147525NIP TRANSFER COMMISSION FOR000013210222160431000010147525 via GTWORLD  TO IBRAHIM ASHAFA ReF:GW681976569000002100002102221603,SAVINGS ACCOUNT,GT_Bank,./static/raw/MR_IBRAHIM_ASHAFA_STATEMENT.pdf,COMMISSION NIP TRANSFER COMMISSION FOR via GTWORLD TO IBRAHIM ASHAFA ReF GW,COMMISSION NIP TRANSFER COMMISSION FOR via GTWORLD TO IBRAHIM ASHAFA ReF GW,commission
22-Feb-2021,'0NIPG,22-Feb-2021,3.75,,"360,469.14",VALUE ADDED TAX 000013210222160431000010147525 VAT ON NIP TRANSFER FOR 000013210222160431000010147525 via GTWORLD  TO IBRAHIM ASHAFA ReF:GW681976569000002100002102221603,SAVINGS ACCOUNT,GT_Bank,./static/raw/MR_IBRAHIM_ASHAFA_STATEMENT.pdf,VALUE ADDED TAX VAT ON NIP TRANSFER FOR via GTWORLD TO IBRAHIM ASHAFA ReF GW,VALUE ADDED TAX VAT ON NIP TRANSFER FOR via GTWORLD TO IBRAHIM ASHAFA ReF GW,tax
22-Feb-2021,'0NIPG,22-Feb-2021,"25,000.00",,"335,469.14",NIBSS Instant Payment Outward 000013210222160927000010155575 via GTWORLD  TO UBA/ABDULLAHI ASHAFA /26.875/REF:GW6819765690000002500021022216 f,SAVINGS ACCOUNT,GT_Bank,./static/raw/MR_IBRAHIM_ASHAFA_STATEMENT.pdf,NIBSS Instant Payment Outward via GTWORLD TO UBA ABDULLAHI ASHAFA REF GW f,NIBSS Instant Payment Outward via GTWORLD TO UBA ABDULLAHI ASHAFA REF GW,transfert
22-Feb-2021,'0NIPG,22-Feb-2021,25.00,,"335,444.14",COMMISSION 000013210222160927000010155575 NIP TRANSFER COMMISSION FOR 000013210222160927000010155575 via GTWORLD  TO UBA/ABDULLAHI ASHAFA ReF:GW681976569000000250002102221607,SAVINGS ACCOUNT,GT_Bank,./static/raw/MR_IBRAHIM_ASHAFA_STATEMENT.pdf,COMMISSION NIP TRANSFER COMMISSION FOR via GTWORLD TO UBA ABDULLAHI ASHAFA ReF GW,COMMISSION NIP TRANSFER COMMISSION FOR via GTWORLD TO UBA ABDULLAHI ASHAFA ReF GW,commission
22-Feb-2021,'0NIPG,22-Feb-2021,1.87,,"335,442.27",VALUE ADDED TAX 000013210222160927000010155575 VAT ON NIP TRANSFER FOR 000013210222160927000010155575 via GTWORLD  TO UBA/ABDULLAHI ASHAFA ReF:GW681976569000000250002102221607,SAVINGS ACCOUNT,GT_Bank,./static/raw/MR_IBRAHIM_ASHAFA_STATEMENT.pdf,VALUE ADDED TAX VAT ON NIP TRANSFER FOR via GTWORLD TO UBA ABDULLAHI ASHAFA ReF GW,VALUE ADDED TAX VAT ON NIP TRANSFER FOR via GTWORLD TO UBA ABDULLAHI ASHAFA ReF GW,tax
22-Feb-2021,'0NIPG,22-Feb-2021,"5,000.00",,"330,442.27",NIBSS Instant Payment Outward 000013210222161402000010162660 via GTWORLD  TO ZBN/JIBRIN UMAR ABUHURAIRA /10.75/REF:GW6819765690000000500021022216  f,SAVINGS ACCOUNT,GT_Bank,./static/raw/MR_IBRAHIM_ASHAFA_STATEMENT.pdf,NIBSS Instant Payment Outward via GTWORLD TO ZBN JIBRIN UMAR ABUHURAIRA REF GW f,NIBSS Instant Payment Outward via GTWORLD TO ZBN JIBRIN UMAR ABUHURAIRA REF GW,transfert
22-Feb-2021,'0NIPG,22-Feb-2021,10.00,,"330,432.27",COMMISSION 000013210222161402000010162660 NIP TRANSFER COMMISSION FOR 000013210222161402000010162660 via GTWORLD  TO ZBN/JIBRIN UMAR ABUHURAIRA ReF:GW681976569000000050002102221611,SAVINGS ACCOUNT,GT_Bank,./static/raw/MR_IBRAHIM_ASHAFA_STATEMENT.pdf,COMMISSION NIP TRANSFER COMMISSION FOR via GTWORLD TO ZBN JIBRIN UMAR ABUHURAIRA ReF GW,COMMISSION NIP TRANSFER COMMISSION FOR via GTWORLD TO ZBN JIBRIN UMAR ABUHURAIRA ReF GW,commission
22-Feb-2021,'0NIPG,22-Feb-2021,.75,,"330,431.52",VALUE ADDED TAX 000013210222161402000010162660 VAT ON NIP TRANSFER FOR 000013210222161402000010162660 via GTWORLD  TO ZBN/JIBRIN UMAR ABUHURAIRAReF:GW681976569000000050002102221611,SAVINGS ACCOUNT,GT_Bank,./static/raw/MR_IBRAHIM_ASHAFA_STATEMENT.pdf,VALUE ADDED TAX VAT ON NIP TRANSFER FOR via GTWORLD TO ZBN JIBRIN UMAR ABUHURAIRAReF GW,VALUE ADDED TAX VAT ON NIP TRANSFER FOR via GTWORLD TO ZBN JIBRIN UMAR ABUHURAIRAReF GW,tax
22-Feb-2021,'0GWTR,22-Feb-2021,"170,000.00",,"160,431.52","TRANSFER BETWEEN CUSTOMERS Via GTWorld REF:681976569000001700002102221614  from ASHAFA IBRAHIM ABDULLAHI  to  SALAMI, ABUBAKAR",SAVINGS ACCOUNT,GT_Bank,./static/raw/MR_IBRAHIM_ASHAFA_STATEMENT.pdf,TRANSFER BETWEEN CUSTOMERS Via GTWorld REF from ASHAFA IBRAHIM ABDULLAHI to SALAMI ABUBAKAR,TRANSFER BETWEEN CUSTOMERS Via GTWorld REF from ASHAFA IBRAHIM ABDULLAHI to SALAMI ABUBAKAR,transfert
22-Feb-2021,'0NIPG,22-Feb-2021,"70,000.00",,"90,431.52",NIBSS Instant Payment Outward 000013210222161720000010167645 via GTWORLD  TO YAKUBU ASHAFA ABDULLAHI /53.75/REF:GW6819765690000007000021022216  f,SAVINGS ACCOUNT,GT_Bank,./static/raw/MR_IBRAHIM_ASHAFA_STATEMENT.pdf,NIBSS Instant Payment Outward via GTWORLD TO YAKUBU ASHAFA ABDULLAHI REF GW f,NIBSS Instant Payment Outward via GTWORLD TO YAKUBU ASHAFA ABDULLAHI REF GW,transfert
22-Feb-2021,'0NIPG,22-Feb-2021,50.00,,"90,381.52",COMMISSION 000013210222161720000010167645 NIP TRANSFER COMMISSION FOR 000013210222161720000010167645 via GTWORLD  TO YAKUBU ASHAFA ABDULLAHI ReF:GW681976569000000700002102221615,SAVINGS ACCOUNT,GT_Bank,./static/raw/MR_IBRAHIM_ASHAFA_STATEMENT.pdf,COMMISSION NIP TRANSFER COMMISSION FOR via GTWORLD TO YAKUBU ASHAFA ABDULLAHI ReF GW,COMMISSION NIP TRANSFER COMMISSION FOR via GTWORLD TO YAKUBU ASHAFA ABDULLAHI ReF GW,commission
22-Feb-2021,'0NIPG,22-Feb-2021,3.75,,"90,377.77",VALUE ADDED TAX 000013210222161720000010167645 VAT ON NIP TRANSFER FOR 000013210222161720000010167645 via GTWORLD  TO YAKUBU ASHAFA ABDULLAHI ReF:GW681976569000000700002102221615,SAVINGS ACCOUNT,GT_Bank,./static/raw/MR_IBRAHIM_ASHAFA_STATEMENT.pdf,VALUE ADDED TAX VAT ON NIP TRANSFER FOR via GTWORLD TO YAKUBU ASHAFA ABDULLAHI ReF GW,VALUE ADDED TAX VAT ON NIP TRANSFER FOR via GTWORLD TO YAKUBU ASHAFA ABDULLAHI ReF GW,tax
22-Feb-2021,'0NIPG,22-Feb-2021,"2,000.00",,"88,377.77",NIBSS Instant Payment Outward 000013210222162934000010186326 via GTWORLD  TO FBN/UMAR ALIYU HUSSAINI /10.75/REF:GW6819765690000000200021022216  f,SAVINGS ACCOUNT,GT_Bank,./static/raw/MR_IBRAHIM_ASHAFA_STATEMENT.pdf,NIBSS Instant Payment Outward via GTWORLD TO FBN UMAR ALIYU HUSSAINI REF GW f,NIBSS Instant Payment Outward via GTWORLD TO FBN UMAR ALIYU HUSSAINI REF GW,transfert
22-Feb-2021,'0NIPG,22-Feb-2021,10.00,,"88,367.77",COMMISSION 000013210222162934000010186326 NIP TRANSFER COMMISSION FOR 000013210222162934000010186326 via GTWORLD  TO FBN/UMAR ALIYU HUSSAINI ReF:GW681976569000000020002102221627,SAVINGS ACCOUNT,GT_Bank,./static/raw/MR_IBRAHIM_ASHAFA_STATEMENT.pdf,COMMISSION NIP TRANSFER COMMISSION FOR via GTWORLD TO FBN UMAR ALIYU HUSSAINI ReF GW,COMMISSION NIP TRANSFER COMMISSION FOR via GTWORLD TO FBN UMAR ALIYU HUSSAINI ReF GW,commission
22-Feb-2021,'0NIPG,22-Feb-2021,.75,,"88,367.02",VALUE ADDED TAX 000013210222162934000010186326 VAT ON NIP TRANSFER FOR 000013210222162934000010186326 via GTWORLD  TO FBN/UMAR ALIYU HUSSAINI ReF:GW681976569000000020002102221627,SAVINGS ACCOUNT,GT_Bank,./static/raw/MR_IBRAHIM_ASHAFA_STATEMENT.pdf,VALUE ADDED TAX VAT ON NIP TRANSFER FOR via GTWORLD TO FBN UMAR ALIYU HUSSAINI ReF GW,VALUE ADDED TAX VAT ON NIP TRANSFER FOR via GTWORLD TO FBN UMAR ALIYU HUSSAINI ReF GW,tax
22-Feb-2021,'0NIPG,22-Feb-2021,"8,000.00",,"80,367.02",NIBSS Instant Payment Outward 000013210222163206000010189816 via GTWORLD  TO ABUBAKAR ABDULRAKIB/26.875/REF:GW6819765690000000800021022216 f,SAVINGS ACCOUNT,GT_Bank,./static/raw/MR_IBRAHIM_ASHAFA_STATEMENT.pdf,NIBSS Instant Payment Outward via GTWORLD TO ABUBAKAR ABDULRAKIB REF GW f,NIBSS Instant Payment Outward via GTWORLD TO ABUBAKAR ABDULRAKIB REF GW,transfert
22-Feb-2021,'0NIPG,22-Feb-2021,25.00,,"80,342.02",COMMISSION 000013210222163206000010189816 NIP TRANSFER COMMISSION FOR 000013210222163206000010189816 via GTWORLD  TO ABUBAKAR ABDULRAKIB ReF:GW681976569000000080002102221630,SAVINGS ACCOUNT,GT_Bank,./static/raw/MR_IBRAHIM_ASHAFA_STATEMENT.pdf,COMMISSION NIP TRANSFER COMMISSION FOR via GTWORLD TO ABUBAKAR ABDULRAKIB ReF GW,COMMISSION NIP TRANSFER COMMISSION FOR via GTWORLD TO ABUBAKAR ABDULRAKIB ReF GW,commission
22-Feb-2021,'0NIPG,22-Feb-2021,1.87,,"80,340.15",VALUE ADDED TAX 000013210222163206000010189816 VAT ON NIP TRANSFER FOR 000013210222163206000010189816 via GTWORLD  TO ABUBAKAR ABDULRAKIB ReF:GW681976569000000080002102221630,SAVINGS ACCOUNT,GT_Bank,./static/raw/MR_IBRAHIM_ASHAFA_STATEMENT.pdf,VALUE ADDED TAX VAT ON NIP TRANSFER FOR via GTWORLD TO ABUBAKAR ABDULRAKIB ReF GW,VALUE ADDED TAX VAT ON NIP TRANSFER FOR via GTWORLD TO ABUBAKAR ABDULRAKIB ReF GW,tax
22-Feb-2021,'0NIPG,22-Feb-2021,"20,000.00",,"60,340.15",NIBSS Instant Payment Outward 000013210222163620000010196331 via GTWORLD  TO STANBIC/HAUWA . MUSA /26.875/REF:GW6819765690000002000021022216 f,SAVINGS ACCOUNT,GT_Bank,./static/raw/MR_IBRAHIM_ASHAFA_STATEMENT.pdf,NIBSS Instant Payment Outward via GTWORLD TO STANBIC HAUWA MUSA REF GW f,NIBSS Instant Payment Outward via GTWORLD TO STANBIC HAUWA MUSA REF GW,transfert
22-Feb-2021,'0NIPG,22-Feb-2021,25.00,,"60,315.15",COMMISSION 000013210222163620000010196331 NIP TRANSFER COMMISSION FOR 000013210222163620000010196331 via GTWORLD  TO STANBIC/HAUWA . MUSA ReF:GW681976569000000200002102221634,SAVINGS ACCOUNT,GT_Bank,./static/raw/MR_IBRAHIM_ASHAFA_STATEMENT.pdf,COMMISSION NIP TRANSFER COMMISSION FOR via GTWORLD TO STANBIC HAUWA MUSA ReF GW,COMMISSION NIP TRANSFER COMMISSION FOR via GTWORLD TO STANBIC HAUWA MUSA ReF GW,commission
22-Feb-2021,'0NIPG,22-Feb-2021,1.87,,"60,313.28",VALUE ADDED TAX 000013210222163620000010196331 VAT ON NIP TRANSFER FOR 000013210222163620000010196331 via GTWORLD  TO STANBIC/HAUWA . MUSA ReF:GW681976569000000200002102221634,SAVINGS ACCOUNT,GT_Bank,./static/raw/MR_IBRAHIM_ASHAFA_STATEMENT.pdf,VALUE ADDED TAX VAT ON NIP TRANSFER FOR via GTWORLD TO STANBIC HAUWA MUSA ReF GW,VALUE ADDED TAX VAT ON NIP TRANSFER FOR via GTWORLD TO STANBIC HAUWA MUSA ReF GW,tax
22-Feb-2021,'0NIPG,22-Feb-2021,"10,000.00",,"50,313.28",NIBSS Instant Payment Outward 000013210222163832000010199317 via GTWORLD  TO AISHA NAMAMA ZUBAIRU /26.875/REF:GW6819765690000001000021022216 f,SAVINGS ACCOUNT,GT_Bank,./static/raw/MR_IBRAHIM_ASHAFA_STATEMENT.pdf,NIBSS Instant Payment Outward via GTWORLD TO AISHA NAMAMA ZUBAIRU REF GW f,NIBSS Instant Payment Outward via GTWORLD TO AISHA NAMAMA ZUBAIRU REF GW,transfert
22-Feb-2021,'0NIPG,22-Feb-2021,25.00,,"50,288.28",COMMISSION 000013210222163832000010199317 NIP TRANSFER COMMISSION FOR 000013210222163832000010199317 via GTWORLD  TO AISHA NAMAMA ZUBAIRU ReF:GW681976569000000100002102221636,SAVINGS ACCOUNT,GT_Bank,./static/raw/MR_IBRAHIM_ASHAFA_STATEMENT.pdf,COMMISSION NIP TRANSFER COMMISSION FOR via GTWORLD TO AISHA NAMAMA ZUBAIRU ReF GW,COMMISSION NIP TRANSFER COMMISSION FOR via GTWORLD TO AISHA NAMAMA ZUBAIRU ReF GW,commission
22-Feb-2021,'0NIPG,22-Feb-2021.1,1.87,,"50,286.41",VALUE ADDED TAX 000013210222163832000010199317 VAT ON NIP TRANSFER FOR 000013210222163832000010199317 via GTWORLD  TO AISHA NAMAMA ZUBAIRU ReF:GW681976569000000100002102221636,SAVINGS ACCOUNT,GT_Bank,./static/raw/MR_IBRAHIM_ASHAFA_STATEMENT.pdf,VALUE ADDED TAX VAT ON NIP TRANSFER FOR via GTWORLD TO AISHA NAMAMA ZUBAIRU ReF GW,VALUE ADDED TAX VAT ON NIP TRANSFER FOR via GTWORLD TO AISHA NAMAMA ZUBAIRU ReF GW,tax
22-Feb-2021,'0NIPG,22-Feb-2021,"35,000.00",,"15,286.41",NIBSS Instant Payment Outward 000013210222163931000010200748 via GTWORLD  TO ASHAFA IBRAHIM /26.875/REF:GW6819765690000003500021022216 f,SAVINGS ACCOUNT,GT_Bank,./static/raw/MR_IBRAHIM_ASHAFA_STATEMENT.pdf,NIBSS Instant Payment Outward via GTWORLD TO ASHAFA IBRAHIM REF GW f,NIBSS Instant Payment Outward via GTWORLD TO ASHAFA IBRAHIM REF GW,transfert
22-Feb-2021,'0NIPG,22-Feb-2021,25.00,,"15,261.41",COMMISSION 000013210222163931000010200748 NIP TRANSFER COMMISSION FOR 000013210222163931000010200748 via GTWORLD  TO ASHAFA IBRAHIM ReF:GW681976569000000350002102221638,SAVINGS ACCOUNT,GT_Bank,./static/raw/MR_IBRAHIM_ASHAFA_STATEMENT.pdf,COMMISSION NIP TRANSFER COMMISSION FOR via GTWORLD TO ASHAFA IBRAHIM ReF GW,COMMISSION NIP TRANSFER COMMISSION FOR via GTWORLD TO ASHAFA IBRAHIM ReF GW,commission
22-Feb-2021,'0NIPG,22-Feb-2021,1.87,,"15,259.54",VALUE ADDED TAX 000013210222163931000010200748 VAT ON NIP TRANSFER FOR 000013210222163931000010200748 via GTWORLD  TO ASHAFA IBRAHIM ReF:GW681976569000000350002102221638,SAVINGS ACCOUNT,GT_Bank,./static/raw/MR_IBRAHIM_ASHAFA_STATEMENT.pdf,VALUE ADDED TAX VAT ON NIP TRANSFER FOR via GTWORLD TO ASHAFA IBRAHIM ReF GW,VALUE ADDED TAX VAT ON NIP TRANSFER FOR via GTWORLD TO ASHAFA IBRAHIM ReF GW,tax
22-Feb-2021,'0USAT,22-Feb-2021,"1,000.00",,"14,259.54",Airtime Purchase GTWORLD- 101CT0000000002388879628-2348038673032,SAVINGS ACCOUNT,GT_Bank,./static/raw/MR_IBRAHIM_ASHAFA_STATEMENT.pdf,Airtime Purchase GTWORLD CT,Airtime Purchase GTWORLD CT,utility
22-Feb-2021,'9302600000,22-Feb-2021,"1,700.00",,"12,559.54",POS/WEB PURCHASE TRANSACTION  -930260- - 049401-AMALA DELIGHT CITY R   FC           FCNG,SAVINGS ACCOUNT,GT_Bank,./static/raw/MR_IBRAHIM_ASHAFA_STATEMENT.pdf,POS WEB PURCHASE TRANSACTION AMALA DELIGHT CITY R FC FCNG,POS WEB PURCHASE TRANSACTION AMALA DELIGHT CITYFC FCNG,utility
22-Feb-2021,'99990039969999,22-Feb-2021,"7,200.00",,"5,359.54",FUNDS TRANSFER  -003996- -094550- 2CRF6438003996 - 539983******1473   LANG,SAVINGS ACCOUNT,GT_Bank,./static/raw/MR_IBRAHIM_ASHAFA_STATEMENT.pdf,FUNDS TRANSFER CRF LANG,FUNDS TRANSFER CRF LANG,transfert
22-Feb-2021,'0,22-Feb-2021,50.00,,"5,309.54",STAMP DUTY CHARGE 22022021 STAMP DUTY CHARGE - 22/02/2021,SAVINGS ACCOUNT,GT_Bank,./static/raw/MR_IBRAHIM_ASHAFA_STATEMENT.pdf,STAMP DUTY CHARGE STAMP DUTY CHARGE,STAMP DUTY CHARGE STAMP DUTY CHARGE,bank_charges
22-Feb-2021,'210,22-Feb-2021,284.00,,"5,025.54",SMS ALERT CHARGE FOR 22JAN2021- 18FEB2021,SAVINGS ACCOUNT,GT_Bank,./static/raw/MR_IBRAHIM_ASHAFA_STATEMENT.pdf,SMS ALERT CHARGE FOR JAN FEB,SMS ALERT CHARGE FOR JAN FEB,loan
23-Feb-2021,'0NIPG,23-Feb-2021,"1,500.00",,"3,525.54",NIBSS Instant Payment Outward 000013210223092850000010883989 via GTWORLD  TO ZAM SHAMMAH DANIEL /10.75/REF:GW6819765690000000150021022309  f,SAVINGS ACCOUNT,GT_Bank,./static/raw/MR_IBRAHIM_ASHAFA_STATEMENT.pdf,NIBSS Instant Payment Outward via GTWORLD TO ZAM SHAMMAH DANIEL REF GW f,NIBSS Instant Payment Outward via GTWORLD TO ZAM SHAMMAH DANIEL REF GW,transfert
23-Feb-2021,'0NIPG,23-Feb-2021,10.00,,"3,515.54",COMMISSION 000013210223092850000010883989NIP TRANSFER COMMISSION FOR 000013210223092850000010883989 via GTWORLD  TO ZAM SHAMMAH DANIEL ReF:GW681976569000000015002102230927,SAVINGS ACCOUNT,GT_Bank,./static/raw/MR_IBRAHIM_ASHAFA_STATEMENT.pdf,COMMISSION NIP TRANSFER COMMISSION FOR via GTWORLD TO ZAM SHAMMAH DANIEL ReF GW,COMMISSION NIP TRANSFER COMMISSION FOR via GTWORLD TO ZAM SHAMMAH DANIEL ReF GW,commission
23-Feb-2021,'0NIPG,23-Feb-2021,.75,,"3,514.79",VALUE ADDED TAX 000013210223092850000010883989 VAT ON NIP TRANSFER FOR 000013210223092850000010883989 via GTWORLD  TO ZAM SHAMMAH DANIEL ReF:GW681976569000000015002102230927,SAVINGS ACCOUNT,GT_Bank,./static/raw/MR_IBRAHIM_ASHAFA_STATEMENT.pdf,VALUE ADDED TAX VAT ON NIP TRANSFER FOR via GTWORLD TO ZAM SHAMMAH DANIEL ReF GW,VALUE ADDED TAX VAT ON NIP TRANSFER FOR via GTWORLD TO ZAM SHAMMAH DANIEL ReF GW,tax
23-Feb-2021,'0USAT,23-Feb-2021,400.00,,"3,114.79",Airtime Purchase GTWORLD- 101CT0000000002390173128-2348038673032,SAVINGS ACCOUNT,GT_Bank,./static/raw/MR_IBRAHIM_ASHAFA_STATEMENT.pdf,Airtime Purchase GTWORLD CT,Airtime Purchase GTWORLD CT,utility
23-Feb-2021,'0USSD,23-Feb-2021,10.00,,"3,104.79",COMMISSION GTBank Loan Enquiry Charge 08038673032 REF: 6374968639146571621963692,SAVINGS ACCOUNT,GT_Bank,./static/raw/MR_IBRAHIM_ASHAFA_STATEMENT.pdf,COMMISSION GTBank Loan Enquiry Charge REF,COMMISSION GTBank Loan Enquiry Charge REF,loan
23-Feb-2021,'0USSD,23-Feb-2021,.75,,"3,104.04",VALUE ADDED TAX GTBank Loan Enquiry VAT 08038673032 REF: 6374968639166275811963692,SAVINGS ACCOUNT,GT_Bank,./static/raw/MR_IBRAHIM_ASHAFA_STATEMENT.pdf,VALUE ADDED TAX GTBank Loan Enquiry VAT REF,VALUE ADDED TAX GTBank Loan Enquiry VAT REF,tax
23-Feb-2021,'99998016099999,23-Feb-2021,35.00,,"3,069.04",ATM WITHDRAWAL COMMISSION  -801609- - 335827-KEYSTONE BANK          WUSE 1         NG,SAVINGS ACCOUNT,GT_Bank,./static/raw/MR_IBRAHIM_ASHAFA_STATEMENT.pdf,ATM WITHDRAWAL COMMISSION KEYSTONE BANK WUSE NG,ATM WITHDRAWAL COMMISSION KEYSTONE BANK WUSE NG,utility
23-Feb-2021,'99998016099999,23-Feb-2021,"3,000.00",,69.04,CASH WITHDRAWAL FROM OTHER ATM  - 801609- -335827-KEYSTONE BANK          WUSE 1 NG,SAVINGS ACCOUNT,GT_Bank,./static/raw/MR_IBRAHIM_ASHAFA_STATEMENT.pdf,CASH WITHDRAWAL FROM OTHER ATM KEYSTONE BANK WUSE NG,CASH WITHDRAWAL FROM OTHER ATM KEYSTONE BANK WUSE NG,cash
26-Feb-2021,'41200012074,26-Feb-2021,"26,529.45",,"-26,460.41",MATURED LOAN INSTALLMENT,SAVINGS ACCOUNT,GT_Bank,./static/raw/MR_IBRAHIM_ASHAFA_STATEMENT.pdf,MATURED LOAN INSTALLMENT,MATURED LOAN INSTALLMENT,loan
28-Feb-2021,'0,28-Feb-2021,60.90,,"-26,521.31",INTEREST CAPITALISED,SAVINGS ACCOUNT,GT_Bank,./static/raw/MR_IBRAHIM_ASHAFA_STATEMENT.pdf,INTEREST CAPITALISED,INTEREST CAPITALISED,loan
01-Mar-2021,'0NIPT,01-Mar-2021,,"43,263.08","16,741.77",TRANSFER BETWEEN CUSTOMERS 000016210301102418000038944683|CIB:REFUND OFDOUBLEPAYMENT|637501910587534822||LIBE RTA LEASING LIMITED REF:000016210301102418000038944683,SAVINGS ACCOUNT,GT_Bank,./static/raw/MR_IBRAHIM_ASHAFA_STATEMENT.pdf,TRANSFER BETWEEN CUSTOMERS CIB REFUND OFDOUBLEPAYMENT LIBE RTA LEASING LIMITED REF,TRANSFER BETWEEN CUSTOMERS CIB REFUND OFDOUBLEPAYMENT LIBE RTA LEASING LIMITED REF,transfert
01-Mar-2021,'0NIPG,01-Mar-2021,"10,000.00",,"6,741.77",NIBSS Instant Payment Outward 000013210301103047000019583944 via GTWORLD  TO LIBERTA LEASING LIMITED /26.875/REF:GW6819765690000001000021030110 f,SAVINGS ACCOUNT,GT_Bank,./static/raw/MR_IBRAHIM_ASHAFA_STATEMENT.pdf,NIBSS Instant Payment Outward via GTWORLD TO LIBERTA LEASING LIMITED REF GW f,NIBSS Instant Payment Outward via GTWORLD TO LIBERTA LEASING LIMITED REF GW,transfert
01-Mar-2021,'0NIPG,01-Mar-2021.1,25.00,,"6,716.77",COMMISSION 000013210301103047000019583944 NIP TRANSFER COMMISSION FOR 000013210301103047000019583944 via GTWORLD  TO LIBERTA LEASING LIMITED ReF:GW681976569000000100002103011029,SAVINGS ACCOUNT,GT_Bank,./static/raw/MR_IBRAHIM_ASHAFA_STATEMENT.pdf,COMMISSION NIP TRANSFER COMMISSION FOR via GTWORLD TO LIBERTA LEASING LIMITED ReF GW,COMMISSION NIP TRANSFER COMMISSION FOR via GTWORLD TO LIBERTA LEASING LIMITED ReF GW,commission
01-Mar-2021,'0NIPG,01-Mar-2021,1.87,,"6,714.90",VALUE ADDED TAX 000013210301103047000019583944 VAT ON NIP TRANSFER FOR 000013210301103047000019583944 via GTWORLD  TO LIBERTA LEASING LIMITED ReF:GW681976569000000100002103011029,SAVINGS ACCOUNT,GT_Bank,./static/raw/MR_IBRAHIM_ASHAFA_STATEMENT.pdf,VALUE ADDED TAX VAT ON NIP TRANSFER FOR via GTWORLD TO LIBERTA LEASING LIMITED ReF GW,VALUE ADDED TAX VAT ON NIP TRANSFER FOR via GTWORLD TO LIBERTA LEASING LIMITED ReF GW,tax
01-Mar-2021,'99999935799999,01-Mar-2021,"5,100.00",,"1,614.90",POS/WEB PURCHASE TRANSACTION  -993579- - 358214-PAYCOM NIGERIA LIMIT   LA           LANG,SAVINGS ACCOUNT,GT_Bank,./static/raw/MR_IBRAHIM_ASHAFA_STATEMENT.pdf,POS WEB PURCHASE TRANSACTION PAYCOM NIGERIA LIMIT LA LANG,POS WEB PURCHASE TRANSACTION PAYCOM NIGERIA LIMIT LA LANG,utility
01-Mar-2021,'0USAT,01-Mar-2021,500.00,,"1,114.90",Airtime Purchase GTWORLD_QL- 101CT0000000002407377704-2348038673032,SAVINGS ACCOUNT,GT_Bank,./static/raw/MR_IBRAHIM_ASHAFA_STATEMENT.pdf,Airtime Purchase GTWORLD_QL CT,Airtime Purchase GTWORLDQL CT,utility
01-Mar-2021,'0USAT,01-Mar-2021,500.00,,614.90,Airtime Purchase GTWORLD_QL- 101CT0000000002407729278-2348030549818,SAVINGS ACCOUNT,GT_Bank,./static/raw/MR_IBRAHIM_ASHAFA_STATEMENT.pdf,Airtime Purchase GTWORLD_QL CT,Airtime Purchase GTWORLDQL CT,utility
01-Mar-2021,'0,01-Mar-2021,50.00,,564.90,STAMP DUTY CHARGE 01032021 STAMP DUTY CHARGE - 01/03/2021,SAVINGS ACCOUNT,GT_Bank,./static/raw/MR_IBRAHIM_ASHAFA_STATEMENT.pdf,STAMP DUTY CHARGE STAMP DUTY CHARGE,STAMP DUTY CHARGE STAMP DUTY CHARGE,bank_charges
01-Mar-2021,'220,01-Mar-2021,21.30,,543.60,VAT ON SMS ALERT CHARGE FOR 22JAN2021- 18FEB2021,SAVINGS ACCOUNT,GT_Bank,./static/raw/MR_IBRAHIM_ASHAFA_STATEMENT.pdf,VAT ON SMS ALERT CHARGE FOR JAN FEB,VAT ON SMS ALERT CHARGE FOR JAN FEB,tax
02-Mar-2021,'0NIPT,02-Mar-2021,,"60,000.00","60,543.60",TRANSFER BETWEEN CUSTOMERS 000003210302122317000751226111|web:TB1c/trf.b y IBRAHIM J.AKUMA/ASHAFA IBRAHIM ABDULLAHI|S88477816||NASARAWA MICROFINANCE BANK LTD REF:000003210302122317000751226111,SAVINGS ACCOUNT,GT_Bank,./static/raw/MR_IBRAHIM_ASHAFA_STATEMENT.pdf,TRANSFER BETWEEN CUSTOMERS web TB c trf b y IBRAHIM J AKUMA ASHAFA IBRAHIM ABDULLAHI S NASARAWA MICROFINANCE BANK LTD REF,TRANSFER BETWEEN CUSTOMERS web TBtrfy IBRAHIMAKUMA ASHAFA IBRAHIM ABDULLAHINASARAWA MICROFINANCE BANK LTD REF,transfert
02-Mar-2021,'0NIPG,02-Mar-2021,"40,000.00",,"20,543.60",NIBSS Instant Payment Outward 000013210302124205000021642530 via GTWORLD  TO JAAFAR I AKUMA /26.875/REF:GW6819765690000004000021030212 f,SAVINGS ACCOUNT,GT_Bank,./static/raw/MR_IBRAHIM_ASHAFA_STATEMENT.pdf,NIBSS Instant Payment Outward via GTWORLD TO JAAFAR I AKUMA REF GW f,NIBSS Instant Payment Outward via GTWORLD TO JAAFARAKUMA REF GW,transfert
02-Mar-2021,'0NIPG,02-Mar-2021,25.00,,"20,518.60",COMMISSION 000013210302124205000021642530 NIP TRANSFER COMMISSION FOR 000013210302124205000021642530 via GTWORLD  TO JAAFAR I AKUMA ReF:GW681976569000000400002103021240,SAVINGS ACCOUNT,GT_Bank,./static/raw/MR_IBRAHIM_ASHAFA_STATEMENT.pdf,COMMISSION NIP TRANSFER COMMISSION FOR via GTWORLD TO JAAFAR I AKUMA ReF GW,COMMISSION NIP TRANSFER COMMISSION FOR via GTWORLD TO JAAFARAKUMA ReF GW,commission
02-Mar-2021,'0NIPG,02-Mar-2021.1,1.87,,"20,516.73",VALUE ADDED TAX 000013210302124205000021642530 VAT ON NIP TRANSFER FOR 000013210302124205000021642530 via GTWORLD  TO JAAFAR I AKUMA ReF:GW681976569000000400002103021240,SAVINGS ACCOUNT,GT_Bank,./static/raw/MR_IBRAHIM_ASHAFA_STATEMENT.pdf,VALUE ADDED TAX VAT ON NIP TRANSFER FOR via GTWORLD TO JAAFAR I AKUMA ReF GW,VALUE ADDED TAX VAT ON NIP TRANSFER FOR via GTWORLD TO JAAFARAKUMA ReF GW,tax
02-Mar-2021,'0NIPG,02-Mar-2021,"10,000.00",,"10,516.73",NIBSS Instant Payment Outward 000013210302124245000021643867 via GTWORLD  TO YUSUF HASSAN /26.875/REF:GW6819765690000001000021030212 f,SAVINGS ACCOUNT,GT_Bank,./static/raw/MR_IBRAHIM_ASHAFA_STATEMENT.pdf,NIBSS Instant Payment Outward via GTWORLD TO YUSUF HASSAN REF GW f,NIBSS Instant Payment Outward via GTWORLD TO YUSUF HASSAN REF GW,transfert
02-Mar-2021,'0NIPG,02-Mar-2021,25.00,,"10,491.73",COMMISSION 000013210302124245000021643867 NIP TRANSFER COMMISSION FOR 000013210302124245000021643867 via GTWORLD  TO YUSUF HASSAN ReF:GW681976569000000100002103021241,SAVINGS ACCOUNT,GT_Bank,./static/raw/MR_IBRAHIM_ASHAFA_STATEMENT.pdf,COMMISSION NIP TRANSFER COMMISSION FOR via GTWORLD TO YUSUF HASSAN ReF GW,COMMISSION NIP TRANSFER COMMISSION FOR via GTWORLD TO YUSUF HASSAN ReF GW,commission
02-Mar-2021,'0NIPG,02-Mar-2021,1.87,,"10,489.86",VALUE ADDED TAX 000013210302124245000021643867 VAT ON NIP TRANSFER FOR 000013210302124245000021643867 via GTWORLD  TO YUSUF HASSAN ReF:GW681976569000000100002103021241,SAVINGS ACCOUNT,GT_Bank,./static/raw/MR_IBRAHIM_ASHAFA_STATEMENT.pdf,VALUE ADDED TAX VAT ON NIP TRANSFER FOR via GTWORLD TO YUSUF HASSAN ReF GW,VALUE ADDED TAX VAT ON NIP TRANSFER FOR via GTWORLD TO YUSUF HASSAN ReF GW,tax
02-Mar-2021,'0NIPT,02-Mar-2021,,"47,144.98","57,634.84",TRANSFER BETWEEN CUSTOMERS 000004210302132046200091038640|TUD IBG/UTO/NetC Feb Sal Ashafa|200091038640||NET CONSTRUCT NIGERIA LIMITED REF:000004210302132046200091038640,SAVINGS ACCOUNT,GT_Bank,./static/raw/MR_IBRAHIM_ASHAFA_STATEMENT.pdf,TRANSFER BETWEEN CUSTOMERS TUD IBG UTO NetC Feb Sal Ashafa NET CONSTRUCT NIGERIA LIMITED REF,TRANSFER BETWEEN CUSTOMERS TUD IBG UTO NetC Feb Sal Ashafa NET CONSTRUCT NIGERIA LIMITED REF,transfert
02-Mar-2021,'0USAT,02-Mar-2021,300.00,,"57,334.84",Airtime Purchase GTWORLD_QL- 101CT0000000002409122337-2348036417835,SAVINGS ACCOUNT,GT_Bank,./static/raw/MR_IBRAHIM_ASHAFA_STATEMENT.pdf,Airtime Purchase GTWORLD_QL CT,Airtime Purchase GTWORLDQL CT,utility
02-Mar-2021,'99996792309999,02-Mar-2021,200.00,,"57,134.84",PURCHASE/TRANSFER COMMISSION  -679230- - 025081-WT|IROEGBULAM MARTHA            ABUJA NG,SAVINGS ACCOUNT,GT_Bank,./static/raw/MR_IBRAHIM_ASHAFA_STATEMENT.pdf,PURCHASE TRANSFER COMMISSION WT IROEGBULAM MARTHA ABUJA NG,PURCHASE TRANSFER COMMISSION WT IROEGBULAM MARTHA ABUJA NG,transfert
02-Mar-2021,'99996792309999,02-Mar-2021,"10,100.00",,"47,034.84",ATM/POS ACOUNT TO ACCOUNT TRANSFER  - 679230- -025081-WT|IROEGBULAM MARTHA ABUJA NG,SAVINGS ACCOUNT,GT_Bank,./static/raw/MR_IBRAHIM_ASHAFA_STATEMENT.pdf,ATM POS ACOUNT TO ACCOUNT TRANSFER WT IROEGBULAM MARTHA ABUJA NG,ATM POS ACOUNT TO ACCOUNT TRANSFER WT IROEGBULAM MARTHA ABUJA NG,transfert
02-Mar-2021,'0USSD,02-Mar-2021,10.00,,"47,024.84",COMMISSION GTBank Balance Enquiry Charge 08038673032 REF:6375029029873783741963692,SAVINGS ACCOUNT,GT_Bank,./static/raw/MR_IBRAHIM_ASHAFA_STATEMENT.pdf,COMMISSION GTBank Balance Enquiry Charge REF,COMMISSION GTBank Balance Enquiry Charge REF,transfert
02-Mar-2021,'0USSD,02-Mar-2021,.75,,"47,024.09",VALUE ADDED TAX GTBank Balance Enquiry VAT 08038673032 REF: 6375029029904088621963692,SAVINGS ACCOUNT,GT_Bank,./static/raw/MR_IBRAHIM_ASHAFA_STATEMENT.pdf,VALUE ADDED TAX GTBank Balance Enquiry VAT REF,VALUE ADDED TAX GTBank Balance Enquiry VAT REF,tax
02-Mar-2021,'0GWTR,02-Mar-2021,"1,500.00",,"45,524.09","TRANSFER BETWEEN CUSTOMERS Via GTWorld REF:681976569000000015002103021504  from ASHAFA IBRAHIM ABDULLAHI  to  AKPAN, SARAH PAUL",SAVINGS ACCOUNT,GT_Bank,./static/raw/MR_IBRAHIM_ASHAFA_STATEMENT.pdf,TRANSFER BETWEEN CUSTOMERS Via GTWorld REF from ASHAFA IBRAHIM ABDULLAHI to AKPAN SARAH PAUL,TRANSFER BETWEEN CUSTOMERS Via GTWorld REF from ASHAFA IBRAHIM ABDULLAHI to AKPAN SARAH PAUL,transfert
02-Mar-2021,'0USAT,02-Mar-2021,300.00,,"45,224.09",Airtime Purchase GTWORLD- 101CT0000000002409357752-2348038673032,SAVINGS ACCOUNT,GT_Bank,./static/raw/MR_IBRAHIM_ASHAFA_STATEMENT.pdf,Airtime Purchase GTWORLD CT,Airtime Purchase GTWORLD CT,utility
02-Mar-2021,'0NIPG,02-Mar-2021,"3,000.00",,"42,224.09",NIBSS Instant Payment Outward 000013210302160009000022038110 via GTWORLD  TO YUSUF HASSAN /10.75/REF:GW6819765690000000300021030215  f,SAVINGS ACCOUNT,GT_Bank,./static/raw/MR_IBRAHIM_ASHAFA_STATEMENT.pdf,NIBSS Instant Payment Outward via GTWORLD TO YUSUF HASSAN REF GW f,NIBSS Instant Payment Outward via GTWORLD TO YUSUF HASSAN REF GW,transfert
02-Mar-2021,'0NIPG,02-Mar-2021,10.00,,"42,214.09",COMMISSION 000013210302160009000022038110 NIP TRANSFER COMMISSION FOR 000013210302160009000022038110 via GTWORLD  TO YUSUF HASSAN ReF:GW681976569000000030002103021558,SAVINGS ACCOUNT,GT_Bank,./static/raw/MR_IBRAHIM_ASHAFA_STATEMENT.pdf,COMMISSION NIP TRANSFER COMMISSION FOR via GTWORLD TO YUSUF HASSAN ReF GW,COMMISSION NIP TRANSFER COMMISSION FOR via GTWORLD TO YUSUF HASSAN ReF GW,commission
02-Mar-2021,'0NIPG,02-Mar-2021,.75,,"42,213.34",VALUE ADDED TAX 000013210302160009000022038110 VAT ON NIP TRANSFER FOR 000013210302160009000022038110 via GTWORLD  TO YUSUF HASSAN ReF:GW681976569000000030002103021558,SAVINGS ACCOUNT,GT_Bank,./static/raw/MR_IBRAHIM_ASHAFA_STATEMENT.pdf,VALUE ADDED TAX VAT ON NIP TRANSFER FOR via GTWORLD TO YUSUF HASSAN ReF GW,VALUE ADDED TAX VAT ON NIP TRANSFER FOR via GTWORLD TO YUSUF HASSAN ReF GW,tax
02-Mar-2021,'0USAT,02-Mar-2021,600.00,,"41,613.34",Airtime Purchase GTWORLD- 101CT0000000002409506121-2348038673032,SAVINGS ACCOUNT,GT_Bank,./static/raw/MR_IBRAHIM_ASHAFA_STATEMENT.pdf,Airtime Purchase GTWORLD CT,Airtime Purchase GTWORLD CT,utility
02-Mar-2021,'0USAT,02-Mar-2021,400.00,,"41,213.34",Airtime Purchase GTWORLD- 101CT0000000002409510329-2348030549818,SAVINGS ACCOUNT,GT_Bank,./static/raw/MR_IBRAHIM_ASHAFA_STATEMENT.pdf,Airtime Purchase GTWORLD CT,Airtime Purchase GTWORLD CT,utility
02-Mar-2021,'99996544999999,02-Mar-2021,"10,000.00",,"31,213.34",CASH WITHDRAWAL FROM OTHER ATM  - 654499- -569587-1057013T0000001 Sahad_ CBN HQ Abuja   NG,SAVINGS ACCOUNT,GT_Bank,./static/raw/MR_IBRAHIM_ASHAFA_STATEMENT.pdf,CASH WITHDRAWAL FROM OTHER ATM T Sahad_ CBN HQ Abuja NG,CASH WITHDRAWAL FROM OTHER ATMSahad CBN HQ Abuja NG,cash
02-Mar-2021,'99990045779999,02-Mar-2021,"5,100.00",,"26,113.34",FUNDS TRANSFER  -004577- -791218-T004577 2TGT1393       LA           LANG,SAVINGS ACCOUNT,GT_Bank,./static/raw/MR_IBRAHIM_ASHAFA_STATEMENT.pdf,FUNDS TRANSFER T TGT LA LANG,FUNDS TRANSFERTGT LA LANG,utility
02-Mar-2021,'0,02-Mar-2021,100.00,,"26,013.34",STAMP DUTY CHARGE 02032021 STAMP DUTY CHARGE - 02/03/2021,SAVINGS ACCOUNT,GT_Bank,./static/raw/MR_IBRAHIM_ASHAFA_STATEMENT.pdf,STAMP DUTY CHARGE STAMP DUTY CHARGE,STAMP DUTY CHARGE STAMP DUTY CHARGE,bank_charges
03-Mar-2021,'0GWTR,03-Mar-2021.1,"5,000.00",,"21,013.34",TRANSFER BETWEEN CUSTOMERS Via GTWorld REF:681976569000000050002103031133  from ASHAFA IBRAHIM ABDULLAHI  to  ALIYU MUHAMMED AHMED,SAVINGS ACCOUNT,GT_Bank,./static/raw/MR_IBRAHIM_ASHAFA_STATEMENT.pdf,TRANSFER BETWEEN CUSTOMERS Via GTWorld REF from ASHAFA IBRAHIM ABDULLAHI to ALIYU MUHAMMED AHMED,TRANSFER BETWEEN CUSTOMERS Via GTWorld REF from ASHAFA IBRAHIM ABDULLAHI to ALIYU MUHAMMED AHMED,transfert
03-Mar-2021,'0NIPG,03-Mar-2021,"10,000.00",,"11,013.34",NIBSS Instant Payment Outward 000013210303113934000023314083 via GTWORLD  TO JIBRIN BASIRAH USMAN /26.875/REF:GW6819765690000001000021030311 f,SAVINGS ACCOUNT,GT_Bank,./static/raw/MR_IBRAHIM_ASHAFA_STATEMENT.pdf,NIBSS Instant Payment Outward via GTWORLD TO JIBRIN BASIRAH USMAN REF GW f,NIBSS Instant Payment Outward via GTWORLD TO JIBRIN BASIRAH USMAN REF GW,transfert
03-Mar-2021,'0NIPG,03-Mar-2021,25.00,,"10,988.34",COMMISSION 000013210303113934000023314083 NIP TRANSFER COMMISSION FOR 000013210303113934000023314083 via GTWORLD  TO JIBRIN BASIRAH USMAN ReF:GW681976569000000100002103031138,SAVINGS ACCOUNT,GT_Bank,./static/raw/MR_IBRAHIM_ASHAFA_STATEMENT.pdf,COMMISSION NIP TRANSFER COMMISSION FOR via GTWORLD TO JIBRIN BASIRAH USMAN ReF GW,COMMISSION NIP TRANSFER COMMISSION FOR via GTWORLD TO JIBRIN BASIRAH USMAN ReF GW,commission
03-Mar-2021,'0NIPG,03-Mar-2021,1.87,,"10,986.47",VALUE ADDED TAX 000013210303113934000023314083 VAT ON NIP TRANSFER FOR 000013210303113934000023314083 via GTWORLD  TO JIBRIN BASIRAH USMAN ReF:GW681976569000000100002103031138,SAVINGS ACCOUNT,GT_Bank,./static/raw/MR_IBRAHIM_ASHAFA_STATEMENT.pdf,VALUE ADDED TAX VAT ON NIP TRANSFER FOR via GTWORLD TO JIBRIN BASIRAH USMAN ReF GW,VALUE ADDED TAX VAT ON NIP TRANSFER FOR via GTWORLD TO JIBRIN BASIRAH USMAN ReF GW,tax
03-Mar-2021,'99998946689999,03-Mar-2021,"7,000.00",,"3,986.47",POS/WEB PURCHASE TRANSACTION  -894668- - 242095-OANDO BELLO RD SS 10   KN KNNG,SAVINGS ACCOUNT,GT_Bank,./static/raw/MR_IBRAHIM_ASHAFA_STATEMENT.pdf,POS WEB PURCHASE TRANSACTION OANDO BELLO RD SS KN KNNG,POS WEB PURCHASE TRANSACTION OANDO BELLO RD SS KN KNNG,utility
03-Mar-2021,'0USAT,03-Mar-2021,800.00,,"3,186.47",Airtime Purchase GTWORLD_QL- 101CT0000000002412128620-2348038673032,SAVINGS ACCOUNT,GT_Bank,./static/raw/MR_IBRAHIM_ASHAFA_STATEMENT.pdf,Airtime Purchase GTWORLD_QL CT,Airtime Purchase GTWORLDQL CT,utility
04-Mar-2021,'0NIPT,04-Mar-2021,,"110,000.00","113,186.47",TRANSFER BETWEEN CUSTOMERS 000026210304144836000003028529|NIP/TRF IFO ASHAFA IBRAHIM ABDULLAHI BO IBRAHIM AS|STAJJNG21030404875215||0000074655 REF:000026210304144836000003028529,SAVINGS ACCOUNT,GT_Bank,./static/raw/MR_IBRAHIM_ASHAFA_STATEMENT.pdf,TRANSFER BETWEEN CUSTOMERS NIP TRF IFO ASHAFA IBRAHIM ABDULLAHI BO IBRAHIM AS STAJJNG REF,TRANSFER BETWEEN CUSTOMERS NIP TRF IFO ASHAFA IBRAHIM ABDULLAHI BO IBRAHIM AS STAJJNG REF,transfert
04-Mar-2021,'0GWTR,04-Mar-2021,"35,000.00",,"78,186.47","TRANSFER BETWEEN CUSTOMERS Via GTWorld REF:681976569000000350002103041504  from ASHAFA IBRAHIM ABDULLAHI  to  SALAMI, ABUBAKAR",SAVINGS ACCOUNT,GT_Bank,./static/raw/MR_IBRAHIM_ASHAFA_STATEMENT.pdf,TRANSFER BETWEEN CUSTOMERS Via GTWorld REF from ASHAFA IBRAHIM ABDULLAHI to SALAMI ABUBAKAR,TRANSFER BETWEEN CUSTOMERS Via GTWorld REF from ASHAFA IBRAHIM ABDULLAHI to SALAMI ABUBAKAR,transfert
04-Mar-2021,'0NIPG,04-Mar-2021,"50,000.00",,"28,186.47",NIBSS Instant Payment Outward 000013210304151012000025451029 via GTWORLD  TO ASHAFA USMAN ABDULLAHI /26.875/REF:GW6819765690000005000021030415f,SAVINGS ACCOUNT,GT_Bank,./static/raw/MR_IBRAHIM_ASHAFA_STATEMENT.pdf,NIBSS Instant Payment Outward via GTWORLD TO ASHAFA USMAN ABDULLAHI REF GW f,NIBSS Instant Payment Outward via GTWORLD TO ASHAFA USMAN ABDULLAHI REF GW,transfert
04-Mar-2021,'0NIPG,04-Mar-2021,25.00,,"28,161.47",COMMISSION 000013210304151012000025451029 NIP TRANSFER COMMISSION FOR 000013210304151012000025451029 via GTWORLD  TO ASHAFA USMAN ABDULLAHI ReF:GW681976569000000500002103041508,SAVINGS ACCOUNT,GT_Bank,./static/raw/MR_IBRAHIM_ASHAFA_STATEMENT.pdf,COMMISSION NIP TRANSFER COMMISSION FOR via GTWORLD TO ASHAFA USMAN ABDULLAHI ReF GW,COMMISSION NIP TRANSFER COMMISSION FOR via GTWORLD TO ASHAFA USMAN ABDULLAHI ReF GW,commission
04-Mar-2021,'0NIPG,04-Mar-2021,1.87,,"28,159.60",VALUE ADDED TAX 000013210304151012000025451029 VAT ON NIP TRANSFER FOR 000013210304151012000025451029 via GTWORLD  TO ASHAFA USMAN ABDULLAHI ReF:GW681976569000000500002103041508,SAVINGS ACCOUNT,GT_Bank,./static/raw/MR_IBRAHIM_ASHAFA_STATEMENT.pdf,VALUE ADDED TAX VAT ON NIP TRANSFER FOR via GTWORLD TO ASHAFA USMAN ABDULLAHI ReF GW,VALUE ADDED TAX VAT ON NIP TRANSFER FOR via GTWORLD TO ASHAFA USMAN ABDULLAHI ReF GW,tax
04-Mar-2021,'0USAT,04-Mar-2021,900.00,,"27,259.60",Airtime Purchase GTWORLD_QL- 101CT0000000002414920384-2348038673032,SAVINGS ACCOUNT,GT_Bank,./static/raw/MR_IBRAHIM_ASHAFA_STATEMENT.pdf,Airtime Purchase GTWORLD_QL CT,Airtime Purchase GTWORLDQL CT,utility
04-Mar-2021,'99991608969999,04-Mar-2021,"5,000.00",,"22,259.60",CASH WITHDRAWAL FROM OTHER ATM  - 160896- -436186-1033264106142 NAWA COM ABUJA          NG,SAVINGS ACCOUNT,GT_Bank,./static/raw/MR_IBRAHIM_ASHAFA_STATEMENT.pdf,CASH WITHDRAWAL FROM OTHER ATM NAWA COM ABUJA NG,CASH WITHDRAWAL FROM OTHER ATM NAWA COM ABUJA NG,cash
04-Mar-2021,'0USAT,04-Mar-2021,900.00,,"21,359.60",Airtime Purchase GTWORLD_QL- 101CT0000000002415905250-2348038673032,SAVINGS ACCOUNT,GT_Bank,./static/raw/MR_IBRAHIM_ASHAFA_STATEMENT.pdf,Airtime Purchase GTWORLD_QL CT,Airtime Purchase GTWORLDQL CT,utility
04-Mar-2021,'0,04-Mar-2021,50.00,,"21,309.60",STAMP DUTY CHARGE 04032021 STAMP DUTY CHARGE - 04/03/2021,SAVINGS ACCOUNT,GT_Bank,./static/raw/MR_IBRAHIM_ASHAFA_STATEMENT.pdf,STAMP DUTY CHARGE STAMP DUTY CHARGE,STAMP DUTY CHARGE STAMP DUTY CHARGE,bank_charges
05-Mar-2021,'0GWTR,05-Mar-2021,"4,000.00",,"17,309.60","TRANSFER BETWEEN CUSTOMERS Via GTWorld REF:681976569000000040002103051841  from ASHAFA IBRAHIM ABDULLAHI  to  SALAMI, ABUBAKAR",SAVINGS ACCOUNT,GT_Bank,./static/raw/MR_IBRAHIM_ASHAFA_STATEMENT.pdf,TRANSFER BETWEEN CUSTOMERS Via GTWorld REF from ASHAFA IBRAHIM ABDULLAHI to SALAMI ABUBAKAR,TRANSFER BETWEEN CUSTOMERS Via GTWorld REF from ASHAFA IBRAHIM ABDULLAHI to SALAMI ABUBAKAR,transfert
06-Mar-2021,'99997745269999,06-Mar-2021,"7,000.00",,"10,309.60","CASH WITHDRAWAL FROM OTHER ATM  - 774526- -384916-105726530000000 ATM3_P IAN,GWARIMPA   NG",SAVINGS ACCOUNT,GT_Bank,./static/raw/MR_IBRAHIM_ASHAFA_STATEMENT.pdf,CASH WITHDRAWAL FROM OTHER ATM ATM _P IAN GWARIMPA NG,CASH WITHDRAWAL FROM OTHER ATM ATM IAN GWARIMPA NG,cash
07-Mar-2021,'99990031749999,07-Mar-2021,"5,000.00",,"5,309.60",POS/WEB PURCHASE TRANSACTION  -003174- - 225891-SHEMA PETROLEUM LIMITEDFC LANG,SAVINGS ACCOUNT,GT_Bank,./static/raw/MR_IBRAHIM_ASHAFA_STATEMENT.pdf,POS WEB PURCHASE TRANSACTION SHEMA PETROLEUM LIMITEDFC LANG,POS WEB PURCHASE TRANSACTION SHEMA PETROLEUM LIMITEDFC LANG,utility
07-Mar-2021,'99996533969999,07-Mar-2021,35.00,,"5,274.60",ATM WITHDRAWAL COMMISSION  -653396- - 307811-000000000011404 Abuja  Wuse           NG,SAVINGS ACCOUNT,GT_Bank,./static/raw/MR_IBRAHIM_ASHAFA_STATEMENT.pdf,ATM WITHDRAWAL COMMISSION Abuja Wuse NG,ATM WITHDRAWAL COMMISSION Abuja Wuse NG,utility
07-Mar-2021,'99996533969999,07-Mar-2021,"5,000.00",,274.60,CASH WITHDRAWAL FROM OTHER ATM  - 653396- -307811-000000000011404 Abuja  Wuse NG,SAVINGS ACCOUNT,GT_Bank,./static/raw/MR_IBRAHIM_ASHAFA_STATEMENT.pdf,CASH WITHDRAWAL FROM OTHER ATM Abuja Wuse NG,CASH WITHDRAWAL FROM OTHER ATM Abuja Wuse NG,cash
08-Mar-2021,'0USAT,08-Mar-2021.1,200.00,,74.60,Airtime Purchase GTWORLD_QL- 101CT0000000002425037784-2348038673032,SAVINGS ACCOUNT,GT_Bank,./static/raw/MR_IBRAHIM_ASHAFA_STATEMENT.pdf,Airtime Purchase GTWORLD_QL CT,Airtime Purchase GTWORLDQL CT,utility
09-Mar-2021,'0USGT,09-Mar-2021,,"8,000.00","8,074.60","TRANSFER BETWEEN CUSTOMERS Via USSD GTBank Transfer 000000003280441867681097656900000080002021 03091141  from IGE-RAPHAEL, OLUWATOYIN  to ASHAFA IBRAHIM ABDULLAHI",SAVINGS ACCOUNT,GT_Bank,./static/raw/MR_IBRAHIM_ASHAFA_STATEMENT.pdf,TRANSFER BETWEEN CUSTOMERS Via USSD GTBank Transfer from IGE RAPHAEL OLUWATOYIN to ASHAFA IBRAHIM ABDULLAHI,TRANSFER BETWEEN CUSTOMERS Via USSD GTBank Transfer from IGE RAPHAEL OLUWATOYIN to ASHAFA IBRAHIM ABDULLAHI,transfert
09-Mar-2021,'0NIPT,09-Mar-2021,,"200,000.00","208,074.60",TRANSFER BETWEEN CUSTOMERS 000015210309115220001554679676|NIP TRF|0||SAVEY FARMS LTD REF:000015210309115220001554679676,SAVINGS ACCOUNT,GT_Bank,./static/raw/MR_IBRAHIM_ASHAFA_STATEMENT.pdf,TRANSFER BETWEEN CUSTOMERS NIP TRF SAVEY FARMS LTD REF,TRANSFER BETWEEN CUSTOMERS NIP TRF SAVEY FARMS LTD REF,transfert
09-Mar-2021,'0USAT,09-Mar-2021,"1,000.00",,"207,074.60",Airtime Purchase GTWORLD_QL- 101CT0000000002426732296-2348038673032,SAVINGS ACCOUNT,GT_Bank,./static/raw/MR_IBRAHIM_ASHAFA_STATEMENT.pdf,Airtime Purchase GTWORLD_QL CT,Airtime Purchase GTWORLDQL CT,utility
09-Mar-2021,'0NIPT,09-Mar-2021,,"750,000.00","957,074.60",TRANSFER BETWEEN CUSTOMERS 000016210309120121000065279828|FBNMOBILE: ASHAFA IBRAHIM ABDULLAHI/ABAJI TORHEE|637508880811453239||ABAJI TORHEE IKYERAVE REF:000016210309120121000065279828,SAVINGS ACCOUNT,GT_Bank,./static/raw/MR_IBRAHIM_ASHAFA_STATEMENT.pdf,TRANSFER BETWEEN CUSTOMERS FBNMOBILE ASHAFA IBRAHIM ABDULLAHI ABAJI TORHEE ABAJI TORHEE IKYERAVE REF,TRANSFER BETWEEN CUSTOMERS FBNMOBILE ASHAFA IBRAHIM ABDULLAHI ABAJI TORHEE ABAJI TORHEE IKYERAVE REF,transfert
09-Mar-2021,'0NIPG,09-Mar-2021,"10,000.00",,"947,074.60",NIBSS Instant Payment Outward 000013210309121210000032579640 via GTWORLD  TO YUSUF HASSAN /26.875/REF:GW6819765690000001000021030912 f,SAVINGS ACCOUNT,GT_Bank,./static/raw/MR_IBRAHIM_ASHAFA_STATEMENT.pdf,NIBSS Instant Payment Outward via GTWORLD TO YUSUF HASSAN REF GW f,NIBSS Instant Payment Outward via GTWORLD TO YUSUF HASSAN REF GW,transfert
09-Mar-2021,'0NIPG,09-Mar-2021,25.00,,"947,049.60",COMMISSION 000013210309121210000032579640 NIP TRANSFER COMMISSION FOR 000013210309121210000032579640 via GTWORLD  TO YUSUF HASSAN ReF:GW681976569000000100002103091210,SAVINGS ACCOUNT,GT_Bank,./static/raw/MR_IBRAHIM_ASHAFA_STATEMENT.pdf,COMMISSION NIP TRANSFER COMMISSION FOR via GTWORLD TO YUSUF HASSAN ReF GW,COMMISSION NIP TRANSFER COMMISSION FOR via GTWORLD TO YUSUF HASSAN ReF GW,commission
09-Mar-2021,'0NIPG,09-Mar-2021,1.87,,"947,047.73",VALUE ADDED TAX 000013210309121210000032579640 VAT ON NIP TRANSFER FOR 000013210309121210000032579640 via GTWORLD  TO YUSUF HASSAN ReF:GW681976569000000100002103091210,SAVINGS ACCOUNT,GT_Bank,./static/raw/MR_IBRAHIM_ASHAFA_STATEMENT.pdf,VALUE ADDED TAX VAT ON NIP TRANSFER FOR via GTWORLD TO YUSUF HASSAN ReF GW,VALUE ADDED TAX VAT ON NIP TRANSFER FOR via GTWORLD TO YUSUF HASSAN ReF GW,tax
09-Mar-2021,'0NIPG,09-Mar-2021,"7,000.00",,"940,047.73",NIBSS Instant Payment Outward 000013210309121326000032582021 via GTWORLD  TO ABDULLAHI ASHAFA/26.875/REF:GW6819765690000000700021030912 f,SAVINGS ACCOUNT,GT_Bank,./static/raw/MR_IBRAHIM_ASHAFA_STATEMENT.pdf,NIBSS Instant Payment Outward via GTWORLD TO ABDULLAHI ASHAFA REF GW f,NIBSS Instant Payment Outward via GTWORLD TO ABDULLAHI ASHAFA REF GW,transfert
09-Mar-2021,'0NIPG,09-Mar-2021,25.00,,"940,022.73",COMMISSION 000013210309121326000032582021 NIP TRANSFER COMMISSION FOR 000013210309121326000032582021 via GTWORLD  TO ABDULLAHI ASHAFA ReF:GW681976569000000070002103091211,SAVINGS ACCOUNT,GT_Bank,./static/raw/MR_IBRAHIM_ASHAFA_STATEMENT.pdf,COMMISSION NIP TRANSFER COMMISSION FOR via GTWORLD TO ABDULLAHI ASHAFA ReF GW,COMMISSION NIP TRANSFER COMMISSION FOR via GTWORLD TO ABDULLAHI ASHAFA ReF GW,commission
09-Mar-2021,'0NIPG,09-Mar-2021,1.87,,"940,020.86",VALUE ADDED TAX 000013210309121326000032582021 VAT ON NIP TRANSFER FOR 000013210309121326000032582021 via GTWORLD  TO ABDULLAHI ASHAFA ReF:GW681976569000000070002103091211,SAVINGS ACCOUNT,GT_Bank,./static/raw/MR_IBRAHIM_ASHAFA_STATEMENT.pdf,VALUE ADDED TAX VAT ON NIP TRANSFER FOR via GTWORLD TO ABDULLAHI ASHAFA ReF GW,VALUE ADDED TAX VAT ON NIP TRANSFER FOR via GTWORLD TO ABDULLAHI ASHAFA ReF GW,tax
09-Mar-2021,'0NIPG,09-Mar-2021,"8,000.00",,"932,020.86",NIBSS Instant Payment Outward 000013210309121518000032585313 via GTWORLD  TO AISHA NAMAMA ZUBAIRU /26.875/REF:GW6819765690000000800021030912 f,SAVINGS ACCOUNT,GT_Bank,./static/raw/MR_IBRAHIM_ASHAFA_STATEMENT.pdf,NIBSS Instant Payment Outward via GTWORLD TO AISHA NAMAMA ZUBAIRU REF GW f,NIBSS Instant Payment Outward via GTWORLD TO AISHA NAMAMA ZUBAIRU REF GW,transfert
09-Mar-2021,'0NIPG,09-Mar-2021,25.00,,"931,995.86",COMMISSION 000013210309121518000032585313 NIP TRANSFER COMMISSION FOR 000013210309121518000032585313 via GTWORLD  TO AISHA NAMAMA ZUBAIRU ReF:GW681976569000000080002103091213,SAVINGS ACCOUNT,GT_Bank,./static/raw/MR_IBRAHIM_ASHAFA_STATEMENT.pdf,COMMISSION NIP TRANSFER COMMISSION FOR via GTWORLD TO AISHA NAMAMA ZUBAIRU ReF GW,COMMISSION NIP TRANSFER COMMISSION FOR via GTWORLD TO AISHA NAMAMA ZUBAIRU ReF GW,commission
09-Mar-2021,'0NIPG,09-Mar-2021,1.87,,"931,993.99",VALUE ADDED TAX 000013210309121518000032585313 VAT ON NIP TRANSFER FOR 000013210309121518000032585313 via GTWORLD  TO AISHA NAMAMA ZUBAIRU ReF:GW681976569000000080002103091213,SAVINGS ACCOUNT,GT_Bank,./static/raw/MR_IBRAHIM_ASHAFA_STATEMENT.pdf,VALUE ADDED TAX VAT ON NIP TRANSFER FOR via GTWORLD TO AISHA NAMAMA ZUBAIRU ReF GW,VALUE ADDED TAX VAT ON NIP TRANSFER FOR via GTWORLD TO AISHA NAMAMA ZUBAIRU ReF GW,tax
09-Mar-2021,'0NIPG,09-Mar-2021,"5,000.00",,"926,993.99",NIBSS Instant Payment Outward 000013210309121612000032587098 via GTWORLD  TO ABUBAKAR ABDULRAKIB /10.75/REF:GW6819765690000000500021030912  f,SAVINGS ACCOUNT,GT_Bank,./static/raw/MR_IBRAHIM_ASHAFA_STATEMENT.pdf,NIBSS Instant Payment Outward via GTWORLD TO ABUBAKAR ABDULRAKIB REF GW f,NIBSS Instant Payment Outward via GTWORLD TO ABUBAKAR ABDULRAKIB REF GW,transfert
09-Mar-2021,'0NIPG,09-Mar-2021,10.00,,"926,983.99",COMMISSION 000013210309121612000032587098 NIP TRANSFER COMMISSION FOR 000013210309121612000032587098 via GTWORLD  TO ABUBAKAR ABDULRAKIB ReF:GW681976569000000050002103091214,SAVINGS ACCOUNT,GT_Bank,./static/raw/MR_IBRAHIM_ASHAFA_STATEMENT.pdf,COMMISSION NIP TRANSFER COMMISSION FOR via GTWORLD TO ABUBAKAR ABDULRAKIB ReF GW,COMMISSION NIP TRANSFER COMMISSION FOR via GTWORLD TO ABUBAKAR ABDULRAKIB ReF GW,commission
09-Mar-2021,'0NIPG,09-Mar-2021.1,.75,,"926,983.24",VALUE ADDED TAX 000013210309121612000032587098 VAT ON NIP TRANSFER FOR 000013210309121612000032587098 via GTWORLD  TO ABUBAKAR ABDULRAKIB ReF:GW681976569000000050002103091214,SAVINGS ACCOUNT,GT_Bank,./static/raw/MR_IBRAHIM_ASHAFA_STATEMENT.pdf,VALUE ADDED TAX VAT ON NIP TRANSFER FOR via GTWORLD TO ABUBAKAR ABDULRAKIB ReF GW,VALUE ADDED TAX VAT ON NIP TRANSFER FOR via GTWORLD TO ABUBAKAR ABDULRAKIB ReF GW,tax
09-Mar-2021,'0NIPG,09-Mar-2021,"10,000.00",,"916,983.24",NIBSS Instant Payment Outward 000013210309122532000032603782 via GTWORLD  TO MUHAMMEDDEEN MUNTAKA ABDULLAHI /26.875/REF:GW6819765690000001000021030912 f,SAVINGS ACCOUNT,GT_Bank,./static/raw/MR_IBRAHIM_ASHAFA_STATEMENT.pdf,NIBSS Instant Payment Outward via GTWORLD TO MUHAMMEDDEEN MUNTAKA ABDULLAHI REF GW f,NIBSS Instant Payment Outward via GTWORLD TO MUHAMMEDDEEN MUNTAKA ABDULLAHI REF GW,transfert
09-Mar-2021,'0NIPG,09-Mar-2021,25.00,,"916,958.24",COMMISSION 000013210309122532000032603782 NIP TRANSFER COMMISSION FOR 000013210309122532000032603782 via GTWORLD  TO MUHAMMEDDEEN MUNTAKA ABDULLAHI ReF:GW681976569000000100002103091224,SAVINGS ACCOUNT,GT_Bank,./static/raw/MR_IBRAHIM_ASHAFA_STATEMENT.pdf,COMMISSION NIP TRANSFER COMMISSION FOR via GTWORLD TO MUHAMMEDDEEN MUNTAKA ABDULLAHI ReF GW,COMMISSION NIP TRANSFER COMMISSION FOR via GTWORLD TO MUHAMMEDDEEN MUNTAKA ABDULLAHI ReF GW,commission
09-Mar-2021,'0NIPG,09-Mar-2021,1.87,,"916,956.37",VALUE ADDED TAX 000013210309122532000032603782 VAT ON NIP TRANSFER FOR 000013210309122532000032603782 via GTWORLD  TO MUHAMMEDDEEN MUNTAKA ABDULLAHI ReF:GW681976569000000100002103091224,SAVINGS ACCOUNT,GT_Bank,./static/raw/MR_IBRAHIM_ASHAFA_STATEMENT.pdf,VALUE ADDED TAX VAT ON NIP TRANSFER FOR via GTWORLD TO MUHAMMEDDEEN MUNTAKA ABDULLAHI ReF GW,VALUE ADDED TAX VAT ON NIP TRANSFER FOR via GTWORLD TO MUHAMMEDDEEN MUNTAKA ABDULLAHI ReF GW,tax
09-Mar-2021,'0NIPG,09-Mar-2021,"70,000.00",,"846,956.37",NIBSS Instant Payment Outward 000013210309122629000032605630 via GTWORLD  TO ALIYU HAUWA /53.75/REF:GW6819765690000007000021030912  f,SAVINGS ACCOUNT,GT_Bank,./static/raw/MR_IBRAHIM_ASHAFA_STATEMENT.pdf,NIBSS Instant Payment Outward via GTWORLD TO ALIYU HAUWA REF GW f,NIBSS Instant Payment Outward via GTWORLD TO ALIYU HAUWA REF GW,transfert
09-Mar-2021,'0NIPG,09-Mar-2021,50.00,,"846,906.37",COMMISSION 000013210309122629000032605630 NIP TRANSFER COMMISSION FOR 000013210309122629000032605630 via GTWORLD  TO ALIYU HAUWA ReF:GW681976569000000700002103091225,SAVINGS ACCOUNT,GT_Bank,./static/raw/MR_IBRAHIM_ASHAFA_STATEMENT.pdf,COMMISSION NIP TRANSFER COMMISSION FOR via GTWORLD TO ALIYU HAUWA ReF GW,COMMISSION NIP TRANSFER COMMISSION FOR via GTWORLD TO ALIYU HAUWA ReF GW,commission
09-Mar-2021,'0NIPG,09-Mar-2021,3.75,,"846,902.62",VALUE ADDED TAX 000013210309122629000032605630 VAT ON NIP TRANSFER FOR 000013210309122629000032605630 via GTWORLD  TO ALIYU HAUWAReF:GW681976569000000700002103091225,SAVINGS ACCOUNT,GT_Bank,./static/raw/MR_IBRAHIM_ASHAFA_STATEMENT.pdf,VALUE ADDED TAX VAT ON NIP TRANSFER FOR via GTWORLD TO ALIYU HAUWAReF GW,VALUE ADDED TAX VAT ON NIP TRANSFER FOR via GTWORLD TO ALIYU HAUWAReF GW,tax
09-Mar-2021,'0NIPG,09-Mar-2021,"70,000.00",,"776,902.62",NIBSS Instant Payment Outward 000013210309122818000032608912 via GTWORLD  TO DEMIDE ENEYAMIRE JEMILATU /53.75/REF:GW6819765690000007000021030912  f,SAVINGS ACCOUNT,GT_Bank,./static/raw/MR_IBRAHIM_ASHAFA_STATEMENT.pdf,NIBSS Instant Payment Outward via GTWORLD TO DEMIDE ENEYAMIRE JEMILATU REF GW f,NIBSS Instant Payment Outward via GTWORLD TO DEMIDE ENEYAMIRE JEMILATU REF GW,transfert
09-Mar-2021,'0NIPG,09-Mar-2021,50.00,,"776,852.62",COMMISSION 000013210309122818000032608912 NIP TRANSFER COMMISSION FOR 000013210309122818000032608912 via GTWORLD  TO DEMIDE ENEYAMIRE JEMILATU ReF:GW681976569000000700002103091226,SAVINGS ACCOUNT,GT_Bank,./static/raw/MR_IBRAHIM_ASHAFA_STATEMENT.pdf,COMMISSION NIP TRANSFER COMMISSION FOR via GTWORLD TO DEMIDE ENEYAMIRE JEMILATU ReF GW,COMMISSION NIP TRANSFER COMMISSION FOR via GTWORLD TO DEMIDE ENEYAMIRE JEMILATU ReF GW,commission
09-Mar-2021,'0NIPG,09-Mar-2021,3.75,,"776,848.87",VALUE ADDED TAX 000013210309122818000032608912 VAT ON NIP TRANSFER FOR 000013210309122818000032608912 via GTWORLD  TO DEMIDE ENEYAMIRE JEMILATU ReF:GW681976569000000700002103091226,SAVINGS ACCOUNT,GT_Bank,./static/raw/MR_IBRAHIM_ASHAFA_STATEMENT.pdf,VALUE ADDED TAX VAT ON NIP TRANSFER FOR via GTWORLD TO DEMIDE ENEYAMIRE JEMILATU ReF GW,VALUE ADDED TAX VAT ON NIP TRANSFER FOR via GTWORLD TO DEMIDE ENEYAMIRE JEMILATU ReF GW,tax
09-Mar-2021,'0NIPG,09-Mar-2021,"30,000.00",,"746,848.87",NIBSS Instant Payment Outward 000013210309122940000032611331 via GTWORLD  TO YAKUBU ASHAFA ABDULLAHI /26.875/REF:GW6819765690000003000021030912 f,SAVINGS ACCOUNT,GT_Bank,./static/raw/MR_IBRAHIM_ASHAFA_STATEMENT.pdf,NIBSS Instant Payment Outward via GTWORLD TO YAKUBU ASHAFA ABDULLAHI REF GW f,NIBSS Instant Payment Outward via GTWORLD TO YAKUBU ASHAFA ABDULLAHI REF GW,transfert
09-Mar-2021,'0NIPG,09-Mar-2021,25.00,,"746,823.87",COMMISSION 000013210309122940000032611331 NIP TRANSFER COMMISSION FOR 000013210309122940000032611331 via GTWORLD  TO YAKUBU ASHAFA ABDULLAHI ReF:GW681976569000000300002103091228,SAVINGS ACCOUNT,GT_Bank,./static/raw/MR_IBRAHIM_ASHAFA_STATEMENT.pdf,COMMISSION NIP TRANSFER COMMISSION FOR via GTWORLD TO YAKUBU ASHAFA ABDULLAHI ReF GW,COMMISSION NIP TRANSFER COMMISSION FOR via GTWORLD TO YAKUBU ASHAFA ABDULLAHI ReF GW,commission
09-Mar-2021,'0NIPG,09-Mar-2021,1.87,,"746,822.00",VALUE ADDED TAX 000013210309122940000032611331 VAT ON NIP TRANSFER FOR 000013210309122940000032611331 via GTWORLD  TO YAKUBU ASHAFA ABDULLAHI ReF:GW681976569000000300002103091228,SAVINGS ACCOUNT,GT_Bank,./static/raw/MR_IBRAHIM_ASHAFA_STATEMENT.pdf,VALUE ADDED TAX VAT ON NIP TRANSFER FOR via GTWORLD TO YAKUBU ASHAFA ABDULLAHI ReF GW,VALUE ADDED TAX VAT ON NIP TRANSFER FOR via GTWORLD TO YAKUBU ASHAFA ABDULLAHI ReF GW,tax
09-Mar-2021,'0NIPG,09-Mar-2021,"6,000.00",,"740,822.00",NIBSS Instant Payment Outward 000013210309130120000032666504 via GTWORLD  TO ADAM HAFSAT MOHAMMED /26.875/REF:GW6819765690000000600021030912 f,SAVINGS ACCOUNT,GT_Bank,./static/raw/MR_IBRAHIM_ASHAFA_STATEMENT.pdf,NIBSS Instant Payment Outward via GTWORLD TO ADAM HAFSAT MOHAMMED REF GW f,NIBSS Instant Payment Outward via GTWORLD TO ADAM HAFSAT MOHAMMED REF GW,transfert
09-Mar-2021,'0NIPG,09-Mar-2021,25.00,,"740,797.00",COMMISSION 000013210309130120000032666504NIP TRANSFER COMMISSION FOR 000013210309130120000032666504 via GTWORLD  TO ADAM HAFSAT MOHAMMED ReF:GW681976569000000060002103091259,SAVINGS ACCOUNT,GT_Bank,./static/raw/MR_IBRAHIM_ASHAFA_STATEMENT.pdf,COMMISSION NIP TRANSFER COMMISSION FOR via GTWORLD TO ADAM HAFSAT MOHAMMED ReF GW,COMMISSION NIP TRANSFER COMMISSION FOR via GTWORLD TO ADAM HAFSAT MOHAMMED ReF GW,commission
09-Mar-2021,'0NIPG,09-Mar-2021,1.87,,"740,795.13",VALUE ADDED TAX 000013210309130120000032666504 VAT ON NIP TRANSFER FOR 000013210309130120000032666504 via GTWORLD  TO ADAM HAFSAT MOHAMMED ReF:GW681976569000000060002103091259,SAVINGS ACCOUNT,GT_Bank,./static/raw/MR_IBRAHIM_ASHAFA_STATEMENT.pdf,VALUE ADDED TAX VAT ON NIP TRANSFER FOR via GTWORLD TO ADAM HAFSAT MOHAMMED ReF GW,VALUE ADDED TAX VAT ON NIP TRANSFER FOR via GTWORLD TO ADAM HAFSAT MOHAMMED ReF GW,tax
09-Mar-2021,'0NIPG,09-Mar-2021,"200,000.00",,"540,795.13",NIBSS Instant Payment Outward 000013210309132403000032707943 via GTWORLD  TO IBRAHIM ASHAFA /53.75/REF:GW6819765690000020000021030913  f,SAVINGS ACCOUNT,GT_Bank,./static/raw/MR_IBRAHIM_ASHAFA_STATEMENT.pdf,NIBSS Instant Payment Outward via GTWORLD TO IBRAHIM ASHAFA REF GW f,NIBSS Instant Payment Outward via GTWORLD TO IBRAHIM ASHAFA REF GW,transfert
09-Mar-2021,'0NIPG,09-Mar-2021,50.00,,"540,745.13",COMMISSION 000013210309132403000032707943 NIP TRANSFER COMMISSION FOR 000013210309132403000032707943 via GTWORLD  TO IBRAHIM ASHAFA ReF:GW681976569000002000002103091322,SAVINGS ACCOUNT,GT_Bank,./static/raw/MR_IBRAHIM_ASHAFA_STATEMENT.pdf,COMMISSION NIP TRANSFER COMMISSION FOR via GTWORLD TO IBRAHIM ASHAFA ReF GW,COMMISSION NIP TRANSFER COMMISSION FOR via GTWORLD TO IBRAHIM ASHAFA ReF GW,commission
09-Mar-2021,'0NIPG,09-Mar-2021,3.75,,"540,741.38",VALUE ADDED TAX 000013210309132403000032707943 VAT ON NIP TRANSFER FOR 000013210309132403000032707943 via GTWORLD  TO IBRAHIM ASHAFA ReF:GW681976569000002000002103091322,SAVINGS ACCOUNT,GT_Bank,./static/raw/MR_IBRAHIM_ASHAFA_STATEMENT.pdf,VALUE ADDED TAX VAT ON NIP TRANSFER FOR via GTWORLD TO IBRAHIM ASHAFA ReF GW,VALUE ADDED TAX VAT ON NIP TRANSFER FOR via GTWORLD TO IBRAHIM ASHAFA ReF GW,tax
09-Mar-2021,'0NIPG,09-Mar-2021,"8,000.00",,"532,741.38",NIBSS Instant Payment Outward 000013210309132619000032712396 via GTWORLD  TO MUHAMMED  ABUBAKAR /26.875/REF:GW6819765690000000800021030913 f,SAVINGS ACCOUNT,GT_Bank,./static/raw/MR_IBRAHIM_ASHAFA_STATEMENT.pdf,NIBSS Instant Payment Outward via GTWORLD TO MUHAMMED ABUBAKAR REF GW f,NIBSS Instant Payment Outward via GTWORLD TO MUHAMMED ABUBAKAR REF GW,transfert
09-Mar-2021,'0NIPG,09-Mar-2021,25.00,,"532,716.38",COMMISSION 000013210309132619000032712396 NIP TRANSFER COMMISSION FOR 000013210309132619000032712396 via GTWORLD  TO MUHAMMED  ABUBAKAR ReF:GW681976569000000080002103091324,SAVINGS ACCOUNT,GT_Bank,./static/raw/MR_IBRAHIM_ASHAFA_STATEMENT.pdf,COMMISSION NIP TRANSFER COMMISSION FOR via GTWORLD TO MUHAMMED ABUBAKAR ReF GW,COMMISSION NIP TRANSFER COMMISSION FOR via GTWORLD TO MUHAMMED ABUBAKAR ReF GW,commission
09-Mar-2021,'0NIPG,09-Mar-2021,1.87,,"532,714.51",VALUE ADDED TAX 000013210309132619000032712396 VAT ON NIP TRANSFER FOR 000013210309132619000032712396 viaGTWORLD  TO MUHAMMED  ABUBAKAR ReF:GW681976569000000080002103091324,SAVINGS ACCOUNT,GT_Bank,./static/raw/MR_IBRAHIM_ASHAFA_STATEMENT.pdf,VALUE ADDED TAX VAT ON NIP TRANSFER FOR viaGTWORLD TO MUHAMMED ABUBAKAR ReF GW,VALUE ADDED TAX VAT ON NIP TRANSFER FOR via GTWORLD TO MUHAMMED ABUBAKAR ReF GW,tax
09-Mar-2021,'0GWTR,09-Mar-2021,"30,000.00",,"502,714.51",TRANSFER BETWEEN CUSTOMERS Via GTWorld REF:681976569000000300002103091426  from ASHAFA IBRAHIM ABDULLAHI  to  ALIYU MUHAMMED AHMED,SAVINGS ACCOUNT,GT_Bank,./static/raw/MR_IBRAHIM_ASHAFA_STATEMENT.pdf,TRANSFER BETWEEN CUSTOMERS Via GTWorld REF from ASHAFA IBRAHIM ABDULLAHI to ALIYU MUHAMMED AHMED,TRANSFER BETWEEN CUSTOMERS Via GTWorld REF from ASHAFA IBRAHIM ABDULLAHI to ALIYU MUHAMMED AHMED,transfert
09-Mar-2021,'0NIPG,09-Mar-2021,"350,000.00",,"152,714.51",NIBSS Instant Payment Outward 000013210309150546000032889859 via GTWORLD  TO PREVIEW PHONES VENTURES /53.75/REF:GW6819765690000035000021030915  f,SAVINGS ACCOUNT,GT_Bank,./static/raw/MR_IBRAHIM_ASHAFA_STATEMENT.pdf,NIBSS Instant Payment Outward via GTWORLD TO PREVIEW PHONES VENTURES REF GW f,NIBSS Instant Payment Outward via GTWORLD TO PREVIEW PHONES VENTURES REF GW,transfert
09-Mar-2021,'0NIPG,09-Mar-2021,50.00,,"152,664.51",COMMISSION 000013210309150546000032889859 NIP TRANSFER COMMISSION FOR 000013210309150546000032889859 via GTWORLD  TO PREVIEW PHONES VENTURES ReF:GW681976569000003500002103091504,SAVINGS ACCOUNT,GT_Bank,./static/raw/MR_IBRAHIM_ASHAFA_STATEMENT.pdf,COMMISSION NIP TRANSFER COMMISSION FOR via GTWORLD TO PREVIEW PHONES VENTURES ReF GW,COMMISSION NIP TRANSFER COMMISSION FOR via GTWORLD TO PREVIEW PHONES VENTURES ReF GW,commission
09-Mar-2021,'0NIPG,09-Mar-2021,3.75,,"152,660.76",VALUE ADDED TAX 000013210309150546000032889859 VAT ON NIP TRANSFER FOR 000013210309150546000032889859 via GTWORLD  TO PREVIEW PHONES VENTURES ReF:GW681976569000003500002103091504,SAVINGS ACCOUNT,GT_Bank,./static/raw/MR_IBRAHIM_ASHAFA_STATEMENT.pdf,VALUE ADDED TAX VAT ON NIP TRANSFER FOR via GTWORLD TO PREVIEW PHONES VENTURES ReF GW,VALUE ADDED TAX VAT ON NIP TRANSFER FOR via GTWORLD TO PREVIEW PHONES VENTURES ReF GW,tax
09-Mar-2021,'8563760000,09-Mar-2021,"10,000.00",,"142,660.76",POS/WEB PURCHASE TRANSACTION  -856376- - 435364-SHEMA PETROLEUM LIMI   KD KDNG,SAVINGS ACCOUNT,GT_Bank,./static/raw/MR_IBRAHIM_ASHAFA_STATEMENT.pdf,POS WEB PURCHASE TRANSACTION SHEMA PETROLEUM LIMI KD KDNG,POS WEB PURCHASE TRANSACTION SHEMA PETROLEUM LIMI KD KDNG,utility
09-Mar-2021,'0USSD,09-Mar-2021,10.00,,"142,650.76",COMMISSION GTBank Balance Enquiry Charge 08038673032 REF: 6375090628069242661963692,SAVINGS ACCOUNT,GT_Bank,./static/raw/MR_IBRAHIM_ASHAFA_STATEMENT.pdf,COMMISSION GTBank Balance Enquiry Charge REF,COMMISSION GTBank Balance Enquiry Charge REF,transfert
09-Mar-2021,'0USSD,09-Mar-2021,.75,,"142,650.01",VALUE ADDED TAX GTBank Balance Enquiry VAT 08038673032 REF: 6375090628095807781963692,SAVINGS ACCOUNT,GT_Bank,./static/raw/MR_IBRAHIM_ASHAFA_STATEMENT.pdf,VALUE ADDED TAX GTBank Balance Enquiry VAT REF,VALUE ADDED TAX GTBank Balance Enquiry VAT REF,tax
09-Mar-2021,'55520000,09-Mar-2021,"67,000.00",,"75,650.01",POS/WEB PURCHASE TRANSACTION  -005552- - 831912-SAHAD STORES LTD       LA           LANG,SAVINGS ACCOUNT,GT_Bank,./static/raw/MR_IBRAHIM_ASHAFA_STATEMENT.pdf,POS WEB PURCHASE TRANSACTION SAHAD STORES LTD LA LANG,POS WEB PURCHASE TRANSACTION SAHAD STORES LTD LA LANG,utility
09-Mar-2021,'99995697829999,09-Mar-2021,"14,920.00",,"60,730.01",POS/WEB PURCHASE TRANSACTION  -569782- - 923482-SAHAD STORES LTD CBD   FC LANG,SAVINGS ACCOUNT,GT_Bank,./static/raw/MR_IBRAHIM_ASHAFA_STATEMENT.pdf,POS WEB PURCHASE TRANSACTION SAHAD STORES LTD CBD FC LANG,POS WEB PURCHASE TRANSACTION SAHAD STORES LTD CBD FC LANG,utility
09-Mar-2021,'11480000,09-Mar-2021.1,"2,800.00",,"57,930.01",POS/WEB PURCHASE TRANSACTION  -001148- - 935023-SAHAD STORES LTD (POS RFC LANG,SAVINGS ACCOUNT,GT_Bank,./static/raw/MR_IBRAHIM_ASHAFA_STATEMENT.pdf,POS WEB PURCHASE TRANSACTION SAHAD STORES LTD POS RFC LANG,POS WEB PURCHASE TRANSACTION SAHAD STORES LTD POS RFC LANG,utility
09-Mar-2021,'99997572609999,09-Mar-2021,"4,900.00",,"53,030.01",POS/WEB PURCHASE TRANSACTION  -757260- - 046566-TASTIA RESTAURANT AN   FC FCNG,SAVINGS ACCOUNT,GT_Bank,./static/raw/MR_IBRAHIM_ASHAFA_STATEMENT.pdf,POS WEB PURCHASE TRANSACTION TASTIA RESTAURANT AN FC FCNG,POS WEB PURCHASE TRANSACTION TASTIA RESTAURANT AN FC FCNG,utility
09-Mar-2021,'0USAT,09-Mar-2021,500.00,,"52,530.01",Airtime Purchase USSD- 101CT0000000002428274065-2348038673032,SAVINGS ACCOUNT,GT_Bank,./static/raw/MR_IBRAHIM_ASHAFA_STATEMENT.pdf,Airtime Purchase USSD CT,Airtime Purchase USSD CT,utility
10-Mar-2021,'0,09-Mar-2021,100.00,,"52,430.01",STAMP DUTY CHARGE 09032021 STAMP DUTY CHARGE - 09/03/2021,SAVINGS ACCOUNT,GT_Bank,./static/raw/MR_IBRAHIM_ASHAFA_STATEMENT.pdf,STAMP DUTY CHARGE STAMP DUTY CHARGE,STAMP DUTY CHARGE STAMP DUTY CHARGE,bank_charges
10-Mar-2021,'99998932809999,10-Mar-2021,"12,200.00",,"40,230.01",POS/WEB PURCHASE TRANSACTION  -893280- - 296650-PAYCOM NIGERIA LIMITED Ikeja          NG,SAVINGS ACCOUNT,GT_Bank,./static/raw/MR_IBRAHIM_ASHAFA_STATEMENT.pdf,POS WEB PURCHASE TRANSACTION PAYCOM NIGERIA LIMITED Ikeja NG,POS WEB PURCHASE TRANSACTION PAYCOM NIGERIA LIMITED Ikeja NG,utility
10-Mar-2021,'99995804909999,10-Mar-2021,200.00,,"40,030.01",PURCHASE/TRANSFER COMMISSION  -580490- - 690669-WT|IDOWU FUNSHO                 ABUJA NG,SAVINGS ACCOUNT,GT_Bank,./static/raw/MR_IBRAHIM_ASHAFA_STATEMENT.pdf,PURCHASE TRANSFER COMMISSION WT IDOWU FUNSHO ABUJA NG,PURCHASE TRANSFER COMMISSION WT IDOWU FUNSHO ABUJA NG,transfert
10-Mar-2021,'99995804909999,10-Mar-2021,"20,200.00",,"19,830.01",ATM/POS ACOUNT TO ACCOUNT TRANSFER  - 580490- -690669-WT|IDOWU FUNSHO ABUJA NG,SAVINGS ACCOUNT,GT_Bank,./static/raw/MR_IBRAHIM_ASHAFA_STATEMENT.pdf,ATM POS ACOUNT TO ACCOUNT TRANSFER WT IDOWU FUNSHO ABUJA NG,ATM POS ACOUNT TO ACCOUNT TRANSFER WT IDOWU FUNSHO ABUJA NG,transfert
10-Mar-2021,'99990075699999,10-Mar-2021,"10,100.00",,"9,730.01",FUNDS TRANSFER  -007569- -883778-T007569 2TEPDR21       LA           LANG,SAVINGS ACCOUNT,GT_Bank,./static/raw/MR_IBRAHIM_ASHAFA_STATEMENT.pdf,FUNDS TRANSFER T TEPDR LA LANG,FUNDS TRANSFERTEPDR LA LANG,utility
10-Mar-2021,'0USAT,10-Mar-2021,600.00,,"9,130.01",Airtime Purchase USSD- 101CT0000000002429313569-2348038673032,SAVINGS ACCOUNT,GT_Bank,./static/raw/MR_IBRAHIM_ASHAFA_STATEMENT.pdf,Airtime Purchase USSD CT,Airtime Purchase USSD CT,utility
10-Mar-2021,'0GAPS,10-Mar-2021,,"62,937.50","72,067.51",TRANSFER BETWEEN CUSTOMERS via GAPS com on Sally Abd 2.3M sales 109589436 0 from NETCONSTRUCT NIGERIA LIMITED to ASHAFA IBRAHIM ABDULLAHI REF: 0005628626109589436000000,SAVINGS ACCOUNT,GT_Bank,./static/raw/MR_IBRAHIM_ASHAFA_STATEMENT.pdf,TRANSFER BETWEEN CUSTOMERS via GAPS com on Sally Abd M sales from NETCONSTRUCT NIGERIA LIMITED to ASHAFA IBRAHIM ABDULLAHI REF,TRANSFER BETWEEN CUSTOMERS via GAPS com on Sally Abdsales from NETCONSTRUCT NIGERIA LIMITED to ASHAFA IBRAHIM ABDULLAHI REF,transfert
10-Mar-2021,'0NIPG,10-Mar-2021,"50,000.00",,"22,067.51",NIBSS Instant Payment Outward 000013210310134440000034276081 via GTWORLD  TO HUSSAINI MUSA /26.875/REF:GW6819765690000005000021031013 f,SAVINGS ACCOUNT,GT_Bank,./static/raw/MR_IBRAHIM_ASHAFA_STATEMENT.pdf,NIBSS Instant Payment Outward via GTWORLD TO HUSSAINI MUSA REF GW f,NIBSS Instant Payment Outward via GTWORLD TO HUSSAINI MUSA REF GW,transfert
10-Mar-2021,'0NIPG,10-Mar-2021,25.00,,"22,042.51",COMMISSION 000013210310134440000034276081 NIP TRANSFER COMMISSION FOR 000013210310134440000034276081 via GTWORLD  TO HUSSAINI MUSA ReF:GW681976569000000500002103101343,SAVINGS ACCOUNT,GT_Bank,./static/raw/MR_IBRAHIM_ASHAFA_STATEMENT.pdf,COMMISSION NIP TRANSFER COMMISSION FOR via GTWORLD TO HUSSAINI MUSA ReF GW,COMMISSION NIP TRANSFER COMMISSION FOR via GTWORLD TO HUSSAINI MUSA ReF GW,commission
10-Mar-2021,'0NIPG,10-Mar-2021.1,1.87,,"22,040.64",VALUE ADDED TAX 000013210310134440000034276081 VAT ON NIP TRANSFER FOR 000013210310134440000034276081 via GTWORLD  TO HUSSAINI MUSA ReF:GW681976569000000500002103101343,SAVINGS ACCOUNT,GT_Bank,./static/raw/MR_IBRAHIM_ASHAFA_STATEMENT.pdf,VALUE ADDED TAX VAT ON NIP TRANSFER FOR via GTWORLD TO HUSSAINI MUSA ReF GW,VALUE ADDED TAX VAT ON NIP TRANSFER FOR via GTWORLD TO HUSSAINI MUSA ReF GW,tax
10-Mar-2021,'0USAT,10-Mar-2021,800.00,,"21,240.64",Airtime Purchase GTWORLD_QL- 101CT0000000002430619950-2348030549818,SAVINGS ACCOUNT,GT_Bank,./static/raw/MR_IBRAHIM_ASHAFA_STATEMENT.pdf,Airtime Purchase GTWORLD_QL CT,Airtime Purchase GTWORLDQL CT,utility
10-Mar-2021,'0USAT,10-Mar-2021,"1,000.00",,"20,240.64",Airtime Purchase GTWORLD_QL- 101CT0000000002430622161-2348038673032,SAVINGS ACCOUNT,GT_Bank,./static/raw/MR_IBRAHIM_ASHAFA_STATEMENT.pdf,Airtime Purchase GTWORLD_QL CT,Airtime Purchase GTWORLDQL CT,utility
10-Mar-2021,'0,10-Mar-2021,50.00,,"20,190.64",STAMP DUTY CHARGE 10032021 STAMP DUTY CHARGE - 10/03/2021,SAVINGS ACCOUNT,GT_Bank,./static/raw/MR_IBRAHIM_ASHAFA_STATEMENT.pdf,STAMP DUTY CHARGE STAMP DUTY CHARGE,STAMP DUTY CHARGE STAMP DUTY CHARGE,bank_charges
11-Mar-2021,'99991124149999,11-Mar-2021,"13,000.00",,"7,190.64",POS/WEB PURCHASE TRANSACTION  -112414- - 264975-A. Y. M. SHAFA LTD (   FCNG           NG,SAVINGS ACCOUNT,GT_Bank,./static/raw/MR_IBRAHIM_ASHAFA_STATEMENT.pdf,POS WEB PURCHASE TRANSACTION A Y M SHAFA LTD FCNG NG,POS WEB PURCHASE TRANSACTIONYSHAFA LTD FCNG NG,utility
11-Mar-2021,'99995299589999,11-Mar-2021,100.00,,"7,090.64",PURCHASE/TRANSFER COMMISSION  -529958- - 865524-WT|HARUNA HUSSAINI              ABUJA NG,SAVINGS ACCOUNT,GT_Bank,./static/raw/MR_IBRAHIM_ASHAFA_STATEMENT.pdf,PURCHASE TRANSFER COMMISSION WT HARUNA HUSSAINI ABUJA NG,PURCHASE TRANSFER COMMISSION WT HARUNA HUSSAINI ABUJA NG,transfert
11-Mar-2021,'99995299589999,11-Mar-2021,"7,000.00",,90.64,ATM/POS ACOUNT TO ACCOUNT TRANSFER  - 529958- -865524-WT|HARUNA HUSSAINI ABUJA NG,SAVINGS ACCOUNT,GT_Bank,./static/raw/MR_IBRAHIM_ASHAFA_STATEMENT.pdf,ATM POS ACOUNT TO ACCOUNT TRANSFER WT HARUNA HUSSAINI ABUJA NG,ATM POS ACOUNT TO ACCOUNT TRANSFER WT HARUNA HUSSAINI ABUJA NG,transfert
11-Mar-2021,'0GWTR,11-Mar-2021,,"650,000.00","650,090.64","TRANSFER BETWEEN CUSTOMERS Via GTWorld REF:321254767000006500002103111254  from BABATUNDE, OLULEYE AKINTUNDE  to  ASHAFA IBRAHIM ABDULLAHI",SAVINGS ACCOUNT,GT_Bank,./static/raw/MR_IBRAHIM_ASHAFA_STATEMENT.pdf,TRANSFER BETWEEN CUSTOMERS Via GTWorld REF from BABATUNDE OLULEYE AKINTUNDE to ASHAFA IBRAHIM ABDULLAHI,TRANSFER BETWEEN CUSTOMERS Via GTWorld REF from BABATUNDE OLULEYE AKINTUNDE to ASHAFA IBRAHIM ABDULLAHI,transfert
11-Mar-2021,'0NIPB,11-Mar-2021,"645,000.00",,"5,090.64",NIBSS Instant Payment Outward 000013210311151522000035885325 NIP TO FCMB/NET CONSTRUCT LEGAL ACCOUNT /53.75/REF:001319344930645000002103111515,SAVINGS ACCOUNT,GT_Bank,./static/raw/MR_IBRAHIM_ASHAFA_STATEMENT.pdf,NIBSS Instant Payment Outward NIP TO FCMB NET CONSTRUCT LEGAL ACCOUNT REF,NIBSS Instant Payment Outward NIP TO FCMB NET CONSTRUCT LEGAL ACCOUNT REF,transfert
11-Mar-2021,'0NIPB,11-Mar-2021,50.00,,"5,040.64",COMMISSION 000013210311151522000035885325 NIP TRANSFER COMMISSION FOR 000013210311151522000035885325 NIP TO FCMB/NET CONSTRUCT LEGAL ACCOUNT ReF:001319344930645000002103111515,SAVINGS ACCOUNT,GT_Bank,./static/raw/MR_IBRAHIM_ASHAFA_STATEMENT.pdf,COMMISSION NIP TRANSFER COMMISSION FOR NIP TO FCMB NET CONSTRUCT LEGAL ACCOUNT ReF,COMMISSION NIP TRANSFER COMMISSION FOR NIP TO FCMB NET CONSTRUCT LEGAL ACCOUNT ReF,commission
11-Mar-2021,'0NIPB,11-Mar-2021,3.75,,"5,036.89",VALUE ADDED TAX 000013210311151522000035885325 VAT ON NIP TRANSFER FOR 000013210311151522000035885325 NIP TO FCMB/NET CONSTRUCT LEGAL ACCOUNTReF:001319344930645000002103111515,SAVINGS ACCOUNT,GT_Bank,./static/raw/MR_IBRAHIM_ASHAFA_STATEMENT.pdf,VALUE ADDED TAX VAT ON NIP TRANSFER FOR NIP TO FCMB NET CONSTRUCT LEGAL ACCOUNTReF,VALUE ADDED TAX VAT ON NIP TRANSFER FOR NIP TO FCMB NET CONSTRUCT LEGAL ACCOUNTReF,tax
11-Mar-2021,'0GWTR,11-Mar-2021,,"50,000.00","55,036.89","TRANSFER BETWEEN CUSTOMERS Via GTWorld REF:321254767000000500002103111648  from BABATUNDE, OLULEYE AKINTUNDE  to  ASHAFA IBRAHIM ABDULLAHI",SAVINGS ACCOUNT,GT_Bank,./static/raw/MR_IBRAHIM_ASHAFA_STATEMENT.pdf,TRANSFER BETWEEN CUSTOMERS Via GTWorld REF from BABATUNDE OLULEYE AKINTUNDE to ASHAFA IBRAHIM ABDULLAHI,TRANSFER BETWEEN CUSTOMERS Via GTWorld REF from BABATUNDE OLULEYE AKINTUNDE to ASHAFA IBRAHIM ABDULLAHI,transfert
11-Mar-2021,'0USAT,11-Mar-2021,800.00,,"54,236.89",Airtime Purchase GTWORLD_QL- 101CT0000000002432509346-2348038673032,SAVINGS ACCOUNT,GT_Bank,./static/raw/MR_IBRAHIM_ASHAFA_STATEMENT.pdf,Airtime Purchase GTWORLD_QL CT,Airtime Purchase GTWORLDQL CT,utility
11-Mar-2021,'99990134219999,11-Mar-2021,"4,100.00",,"50,136.89",FUNDS TRANSFER  -013421- -319776-T013421 2TGTB225       LA           LANG,SAVINGS ACCOUNT,GT_Bank,./static/raw/MR_IBRAHIM_ASHAFA_STATEMENT.pdf,FUNDS TRANSFER T TGTB LA LANG,FUNDS TRANSFERTGTB LA LANG,utility
11-Mar-2021,'3182720000,11-Mar-2021,"10,000.00",,"40,136.89",POS/WEB PURCHASE TRANSACTION  -318272- - 580629-SHEMA PETROLEUM LIMI   KD KDNG,SAVINGS ACCOUNT,GT_Bank,./static/raw/MR_IBRAHIM_ASHAFA_STATEMENT.pdf,POS WEB PURCHASE TRANSACTION SHEMA PETROLEUM LIMI KD KDNG,POS WEB PURCHASE TRANSACTION SHEMA PETROLEUM LIMI KD KDNG,utility
11-Mar-2021,'0,11-Mar-2021,50.00,,"40,086.89",STAMP DUTY CHARGE 11032021 STAMP DUTY CHARGE - 11/03/2021,SAVINGS ACCOUNT,GT_Bank,./static/raw/MR_IBRAHIM_ASHAFA_STATEMENT.pdf,STAMP DUTY CHARGE STAMP DUTY CHARGE,STAMP DUTY CHARGE STAMP DUTY CHARGE,bank_charges
12-Mar-2021,'0GWTR,12-Mar-2021,"20,000.00",,"20,086.89",TRANSFER BETWEEN CUSTOMERS Via GTWorld REF:681976569000000200002103120613  from ASHAFA IBRAHIM ABDULLAHI  to  MUHAMMAD ISMAIL RABO,SAVINGS ACCOUNT,GT_Bank,./static/raw/MR_IBRAHIM_ASHAFA_STATEMENT.pdf,TRANSFER BETWEEN CUSTOMERS Via GTWorld REF from ASHAFA IBRAHIM ABDULLAHI to MUHAMMAD ISMAIL RABO,TRANSFER BETWEEN CUSTOMERS Via GTWorld REF from ASHAFA IBRAHIM ABDULLAHI to MUHAMMAD ISMAIL RABO,transfert
12-Mar-2021,'0NIPT,12-Mar-2021,,"4,800.00","24,886.89",TRANSFER BETWEEN CUSTOMERS 000016210312083035000074078180|FBNMOBILE: ASHAFA IBRAHIM ABDULLAHI/DATES AND TIGER NUT|637511346356370298||AYEGBA-KING GRACE EHI REF:000016210312083035000074078180,SAVINGS ACCOUNT,GT_Bank,./static/raw/MR_IBRAHIM_ASHAFA_STATEMENT.pdf,TRANSFER BETWEEN CUSTOMERS FBNMOBILE ASHAFA IBRAHIM ABDULLAHI DATES AND TIGER NUT AYEGBA KING GRACE EHI REF,TRANSFER BETWEEN CUSTOMERS FBNMOBILE ASHAFA IBRAHIM ABDULLAHI DATES AND TIGER NUT AYEGBA KING GRACE EHI REF,transfert
12-Mar-2021,'0USAT,12-Mar-2021,600.00,,"24,286.89",Airtime Purchase GTWORLD_QL- 101CT0000000002433590346-2348038673032,SAVINGS ACCOUNT,GT_Bank,./static/raw/MR_IBRAHIM_ASHAFA_STATEMENT.pdf,Airtime Purchase GTWORLD_QL CT,Airtime Purchase GTWORLDQL CT,utility
12-Mar-2021,'0GAPS,12-Mar-2021,,"712,500.00","736,786.89",TRANSFER BETWEEN CUSTOMERS via GAPS com on Avil services ltd 30M sales 0 from NETCONSTRUCT NIGERIA LIMITED to ASHAFA IBRAHIM ABDULLAHI REF:208716833001319344931203211429,SAVINGS ACCOUNT,GT_Bank,./static/raw/MR_IBRAHIM_ASHAFA_STATEMENT.pdf,TRANSFER BETWEEN CUSTOMERS via GAPS com on Avil services ltd M sales from NETCONSTRUCT NIGERIA LIMITED to ASHAFA IBRAHIM ABDULLAHI REF,TRANSFER BETWEEN CUSTOMERS via GAPS com on Avil services ltdsales from NETCONSTRUCT NIGERIA LIMITED to ASHAFA IBRAHIM ABDULLAHI REF,transfert
12-Mar-2021,'0GWTR,12-Mar-2021,"30,000.00",,"706,786.89","TRANSFER BETWEEN CUSTOMERS Via GTWorld REF:681976569000000300002103121435  from ASHAFA IBRAHIM ABDULLAHI  to  ABDULLAHI, AMINU MUHAMMAD",SAVINGS ACCOUNT,GT_Bank,./static/raw/MR_IBRAHIM_ASHAFA_STATEMENT.pdf,TRANSFER BETWEEN CUSTOMERS Via GTWorld REF from ASHAFA IBRAHIM ABDULLAHI to ABDULLAHI AMINU MUHAMMAD,TRANSFER BETWEEN CUSTOMERS Via GTWorld REF from ASHAFA IBRAHIM ABDULLAHI to ABDULLAHI AMINU MUHAMMAD,transfert
12-Mar-2021,'0NIPT,12-Mar-2021,,"100,000.00","806,786.89",TRANSFER BETWEEN CUSTOMERS 000015210312143726001562712959|T|372267889||MOHAMMED   BAKO REF:000015210312143726001562712959,SAVINGS ACCOUNT,GT_Bank,./static/raw/MR_IBRAHIM_ASHAFA_STATEMENT.pdf,TRANSFER BETWEEN CUSTOMERS T MOHAMMED BAKO REF,TRANSFER BETWEEN CUSTOMERSMOHAMMED BAKO REF,transfert
12-Mar-2021,'0NIPG,12-Mar-2021,"100,000.00",,"706,786.89",NIBSS Instant Payment Outward 000013210312143822000037334217 via GTWORLD  TO IBRAHIM ASHAFA /53.75/REF:GW6819765690000010000021031214  f,SAVINGS ACCOUNT,GT_Bank,./static/raw/MR_IBRAHIM_ASHAFA_STATEMENT.pdf,NIBSS Instant Payment Outward via GTWORLD TO IBRAHIM ASHAFA REF GW f,NIBSS Instant Payment Outward via GTWORLD TO IBRAHIM ASHAFA REF GW,transfert
12-Mar-2021,'0NIPG,12-Mar-2021,50.00,,"706,736.89",COMMISSION 000013210312143822000037334217 NIP TRANSFER COMMISSION FOR 000013210312143822000037334217 via GTWORLD  TO IBRAHIM ASHAFA ReF:GW681976569000001000002103121436,SAVINGS ACCOUNT,GT_Bank,./static/raw/MR_IBRAHIM_ASHAFA_STATEMENT.pdf,COMMISSION NIP TRANSFER COMMISSION FOR via GTWORLD TO IBRAHIM ASHAFA ReF GW,COMMISSION NIP TRANSFER COMMISSION FOR via GTWORLD TO IBRAHIM ASHAFA ReF GW,commission
12-Mar-2021,'0NIPG,12-Mar-2021,3.75,,"706,733.14",VALUE ADDED TAX 000013210312143822000037334217 VAT ON NIP TRANSFER FOR 000013210312143822000037334217 via GTWORLD  TO IBRAHIM ASHAFA ReF:GW681976569000001000002103121436,SAVINGS ACCOUNT,GT_Bank,./static/raw/MR_IBRAHIM_ASHAFA_STATEMENT.pdf,VALUE ADDED TAX VAT ON NIP TRANSFER FOR via GTWORLD TO IBRAHIM ASHAFA ReF GW,VALUE ADDED TAX VAT ON NIP TRANSFER FOR via GTWORLD TO IBRAHIM ASHAFA ReF GW,tax
12-Mar-2021,'0NIPG,12-Mar-2021,"360,000.00",,"346,733.14",NIBSS Instant Payment Outward 000013210312144439000037344377 via GTWORLD  TO ASHAFA USMAN ABDULLAHI /53.75/REF:GW6819765690000036000021031214  f,SAVINGS ACCOUNT,GT_Bank,./static/raw/MR_IBRAHIM_ASHAFA_STATEMENT.pdf,NIBSS Instant Payment Outward via GTWORLD TO ASHAFA USMAN ABDULLAHI REF GW f,NIBSS Instant Payment Outward via GTWORLD TO ASHAFA USMAN ABDULLAHI REF GW,transfert
12-Mar-2021,'0NIPG,12-Mar-2021,50.00,,"346,683.14",COMMISSION 000013210312144439000037344377 NIP TRANSFER COMMISSION FOR 000013210312144439000037344377 via GTWORLD  TO ASHAFA USMAN ABDULLAHI ReF:GW681976569000003600002103121443,SAVINGS ACCOUNT,GT_Bank,./static/raw/MR_IBRAHIM_ASHAFA_STATEMENT.pdf,COMMISSION NIP TRANSFER COMMISSION FOR via GTWORLD TO ASHAFA USMAN ABDULLAHI ReF GW,COMMISSION NIP TRANSFER COMMISSION FOR via GTWORLD TO ASHAFA USMAN ABDULLAHI ReF GW,commission
12-Mar-2021,'0NIPG,12-Mar-2021,3.75,,"346,679.39",VALUE ADDED TAX 000013210312144439000037344377 VAT ON NIP TRANSFER FOR 000013210312144439000037344377 via GTWORLD  TO ASHAFA USMAN ABDULLAHI ReF:GW681976569000003600002103121443,SAVINGS ACCOUNT,GT_Bank,./static/raw/MR_IBRAHIM_ASHAFA_STATEMENT.pdf,VALUE ADDED TAX VAT ON NIP TRANSFER FOR via GTWORLD TO ASHAFA USMAN ABDULLAHI ReF GW,VALUE ADDED TAX VAT ON NIP TRANSFER FOR via GTWORLD TO ASHAFA USMAN ABDULLAHI ReF GW,tax
12-Mar-2021,'0GWTR,12-Mar-2021,"30,000.00",,"316,679.39","TRANSFER BETWEEN CUSTOMERS Via GTWorld REF:681976569000000300002103121444  from ASHAFA IBRAHIM ABDULLAHI  to  ABDULLATIF, RUKAYYA",SAVINGS ACCOUNT,GT_Bank,./static/raw/MR_IBRAHIM_ASHAFA_STATEMENT.pdf,TRANSFER BETWEEN CUSTOMERS Via GTWorld REF from ASHAFA IBRAHIM ABDULLAHI to ABDULLATIF RUKAYYA,TRANSFER BETWEEN CUSTOMERS Via GTWorld REF from ASHAFA IBRAHIM ABDULLAHI to ABDULLATIF RUKAYYA,transfert
12-Mar-2021,'0NIPG,12-Mar-2021,"30,000.00",,"286,679.39",NIBSS Instant Payment Outward 000013210312144853000037351421 viaGTWORLD  TO IBRAHIM ABBA UMAR /26.875/REF:GW6819765690000003000021031214 f,SAVINGS ACCOUNT,GT_Bank,./static/raw/MR_IBRAHIM_ASHAFA_STATEMENT.pdf,NIBSS Instant Payment Outward viaGTWORLD TO IBRAHIM ABBA UMAR REF GW f,NIBSS Instant Payment Outward via GTWORLD TO IBRAHIM ABBA UMAR REF GW,transfert
12-Mar-2021,'0NIPG,12-Mar-2021,25.00,,"286,654.39",COMMISSION 000013210312144853000037351421 NIP TRANSFER COMMISSION FOR 000013210312144853000037351421 via GTWORLD  TO IBRAHIM ABBA UMAR ReF:GW681976569000000300002103121447,SAVINGS ACCOUNT,GT_Bank,./static/raw/MR_IBRAHIM_ASHAFA_STATEMENT.pdf,COMMISSION NIP TRANSFER COMMISSION FOR via GTWORLD TO IBRAHIM ABBA UMAR ReF GW,COMMISSION NIP TRANSFER COMMISSION FOR via GTWORLD TO IBRAHIM ABBA UMAR ReF GW,commission
12-Mar-2021,'0NIPG,12-Mar-2021,1.87,,"286,652.52",VALUE ADDED TAX 000013210312144853000037351421 VAT ON NIP TRANSFER FOR 000013210312144853000037351421 via GTWORLD  TO IBRAHIM ABBA UMAR ReF:GW681976569000000300002103121447,SAVINGS ACCOUNT,GT_Bank,./static/raw/MR_IBRAHIM_ASHAFA_STATEMENT.pdf,VALUE ADDED TAX VAT ON NIP TRANSFER FOR via GTWORLD TO IBRAHIM ABBA UMAR ReF GW,VALUE ADDED TAX VAT ON NIP TRANSFER FOR via GTWORLD TO IBRAHIM ABBA UMAR ReF GW,tax
12-Mar-2021,'0GWTR,12-Mar-2021,"10,000.00",,"276,652.52",TRANSFER BETWEEN CUSTOMERS Via GTWorld REF:681976569000000100002103121454  from ASHAFA IBRAHIM ABDULLAHI  to  MUHAMMAD ISMAIL RABO,SAVINGS ACCOUNT,GT_Bank,./static/raw/MR_IBRAHIM_ASHAFA_STATEMENT.pdf,TRANSFER BETWEEN CUSTOMERS Via GTWorld REF from ASHAFA IBRAHIM ABDULLAHI to MUHAMMAD ISMAIL RABO,TRANSFER BETWEEN CUSTOMERS Via GTWorld REF from ASHAFA IBRAHIM ABDULLAHI to MUHAMMAD ISMAIL RABO,transfert
12-Mar-2021,'0NIPG,12-Mar-2021,"20,000.00",,"256,652.52",NIBSS Instant Payment Outward 000013210312150038000037370666 via GTWORLD  TO HAUWA . MUSA /26.875/REF:GW6819765690000002000021031214 f,SAVINGS ACCOUNT,GT_Bank,./static/raw/MR_IBRAHIM_ASHAFA_STATEMENT.pdf,NIBSS Instant Payment Outward via GTWORLD TO HAUWA MUSA REF GW f,NIBSS Instant Payment Outward via GTWORLD TO HAUWA MUSA REF GW,transfert
12-Mar-2021,'0NIPG,12-Mar-2021,25.00,,"256,627.52",COMMISSION 000013210312150038000037370666 NIP TRANSFER COMMISSION FOR 000013210312150038000037370666 via GTWORLD  TO HAUWA . MUSA ReF:GW681976569000000200002103121459,SAVINGS ACCOUNT,GT_Bank,./static/raw/MR_IBRAHIM_ASHAFA_STATEMENT.pdf,COMMISSION NIP TRANSFER COMMISSION FOR via GTWORLD TO HAUWA MUSA ReF GW,COMMISSION NIP TRANSFER COMMISSION FOR via GTWORLD TO HAUWA MUSA ReF GW,commission
12-Mar-2021,'0NIPG,12-Mar-2021,1.87,,"256,625.65",VALUE ADDED TAX 000013210312150038000037370666 VAT ON NIP TRANSFER FOR 000013210312150038000037370666 via GTWORLD  TO HAUWA . MUSA ReF:GW681976569000000200002103121459,SAVINGS ACCOUNT,GT_Bank,./static/raw/MR_IBRAHIM_ASHAFA_STATEMENT.pdf,VALUE ADDED TAX VAT ON NIP TRANSFER FOR via GTWORLD TO HAUWA MUSA ReF GW,VALUE ADDED TAX VAT ON NIP TRANSFER FOR via GTWORLD TO HAUWA MUSA ReF GW,tax
12-Mar-2021,'0NIPG,12-Mar-2021,"20,000.00",,"236,625.65",NIBSS Instant Payment Outward 000013210312150132000037372135 via GTWORLD  TO ASHAFA USMAN ABDULLAHI /26.875/REF:GW6819765690000002000021031215 f,SAVINGS ACCOUNT,GT_Bank,./static/raw/MR_IBRAHIM_ASHAFA_STATEMENT.pdf,NIBSS Instant Payment Outward via GTWORLD TO ASHAFA USMAN ABDULLAHI REF GW f,NIBSS Instant Payment Outward via GTWORLD TO ASHAFA USMAN ABDULLAHI REF GW,transfert
12-Mar-2021,'0NIPG,12-Mar-2021.1,25.00,,"236,600.65",COMMISSION 000013210312150132000037372135 NIP TRANSFER COMMISSION FOR 000013210312150132000037372135 via GTWORLD  TO ASHAFA USMAN ABDULLAHI ReF:GW681976569000000200002103121500,SAVINGS ACCOUNT,GT_Bank,./static/raw/MR_IBRAHIM_ASHAFA_STATEMENT.pdf,COMMISSION NIP TRANSFER COMMISSION FOR via GTWORLD TO ASHAFA USMAN ABDULLAHI ReF GW,COMMISSION NIP TRANSFER COMMISSION FOR via GTWORLD TO ASHAFA USMAN ABDULLAHI ReF GW,commission
12-Mar-2021,'0NIPG,12-Mar-2021,1.87,,"236,598.78",VALUE ADDED TAX 000013210312150132000037372135 VAT ON NIP TRANSFER FOR 000013210312150132000037372135 via GTWORLD  TO ASHAFA USMAN ABDULLAHI ReF:GW681976569000000200002103121500,SAVINGS ACCOUNT,GT_Bank,./static/raw/MR_IBRAHIM_ASHAFA_STATEMENT.pdf,VALUE ADDED TAX VAT ON NIP TRANSFER FOR via GTWORLD TO ASHAFA USMAN ABDULLAHI ReF GW,VALUE ADDED TAX VAT ON NIP TRANSFER FOR via GTWORLD TO ASHAFA USMAN ABDULLAHI ReF GW,tax
12-Mar-2021,'0NIPG,12-Mar-2021,"20,000.00",,"216,598.78",NIBSS Instant Payment Outward 000013210312150434000037377348 via GTWORLD  TO AISHA NAMAMA ZUBAIRU /26.875/REF:GW6819765690000002000021031215 f,SAVINGS ACCOUNT,GT_Bank,./static/raw/MR_IBRAHIM_ASHAFA_STATEMENT.pdf,NIBSS Instant Payment Outward via GTWORLD TO AISHA NAMAMA ZUBAIRU REF GW f,NIBSS Instant Payment Outward via GTWORLD TO AISHA NAMAMA ZUBAIRU REF GW,transfert
12-Mar-2021,'0NIPG,12-Mar-2021,25.00,,"216,573.78",COMMISSION 000013210312150434000037377348 NIP TRANSFER COMMISSION FOR 000013210312150434000037377348 via GTWORLD  TO AISHA NAMAMA ZUBAIRU ReF:GW681976569000000200002103121503,SAVINGS ACCOUNT,GT_Bank,./static/raw/MR_IBRAHIM_ASHAFA_STATEMENT.pdf,COMMISSION NIP TRANSFER COMMISSION FOR via GTWORLD TO AISHA NAMAMA ZUBAIRU ReF GW,COMMISSION NIP TRANSFER COMMISSION FOR via GTWORLD TO AISHA NAMAMA ZUBAIRU ReF GW,commission
12-Mar-2021,'0NIPG,12-Mar-2021,1.87,,"216,571.91",VALUE ADDED TAX 000013210312150434000037377348 VAT ON NIP TRANSFER FOR 000013210312150434000037377348 via GTWORLD  TO AISHA NAMAMA ZUBAIRU ReF:GW681976569000000200002103121503,SAVINGS ACCOUNT,GT_Bank,./static/raw/MR_IBRAHIM_ASHAFA_STATEMENT.pdf,VALUE ADDED TAX VAT ON NIP TRANSFER FOR via GTWORLD TO AISHA NAMAMA ZUBAIRU ReF GW,VALUE ADDED TAX VAT ON NIP TRANSFER FOR via GTWORLD TO AISHA NAMAMA ZUBAIRU ReF GW,tax
12-Mar-2021,'0GWTR,12-Mar-2021,"10,000.00",,"206,571.91",TRANSFER BETWEEN CUSTOMERS Via GTWorld REF:681976569000000100002103121505  from ASHAFA IBRAHIM ABDULLAHI  to  ALIYU MUHAMMED AHMED,SAVINGS ACCOUNT,GT_Bank,./static/raw/MR_IBRAHIM_ASHAFA_STATEMENT.pdf,TRANSFER BETWEEN CUSTOMERS Via GTWorld REF from ASHAFA IBRAHIM ABDULLAHI to ALIYU MUHAMMED AHMED,TRANSFER BETWEEN CUSTOMERS Via GTWorld REF from ASHAFA IBRAHIM ABDULLAHI to ALIYU MUHAMMED AHMED,transfert
12-Mar-2021,'0NIPG,12-Mar-2021,"80,000.00",,"126,571.91",NIBSS Instant Payment Outward 000013210312161123000037491613 via GTWORLD  TO IBRAHIM ASHAFA /53.75/REF:GW6819765690000008000021031216  f,SAVINGS ACCOUNT,GT_Bank,./static/raw/MR_IBRAHIM_ASHAFA_STATEMENT.pdf,NIBSS Instant Payment Outward via GTWORLD TO IBRAHIM ASHAFA REF GW f,NIBSS Instant Payment Outward via GTWORLD TO IBRAHIM ASHAFA REF GW,transfert
12-Mar-2021,'0NIPG,12-Mar-2021,50.00,,"126,521.91",COMMISSION 000013210312161123000037491613 NIP TRANSFER COMMISSION FOR 000013210312161123000037491613 via GTWORLD  TO IBRAHIM ASHAFAReF:GW681976569000000800002103121609,SAVINGS ACCOUNT,GT_Bank,./static/raw/MR_IBRAHIM_ASHAFA_STATEMENT.pdf,COMMISSION NIP TRANSFER COMMISSION FOR via GTWORLD TO IBRAHIM ASHAFAReF GW,COMMISSION NIP TRANSFER COMMISSION FOR via GTWORLD TO IBRAHIM ASHAFAReF GW,commission
12-Mar-2021,'0NIPG,12-Mar-2021,3.75,,"126,518.16",VALUE ADDED TAX 000013210312161123000037491613 VAT ON NIP TRANSFER FOR 000013210312161123000037491613 via GTWORLD  TO IBRAHIM ASHAFA ReF:GW681976569000000800002103121609,SAVINGS ACCOUNT,GT_Bank,./static/raw/MR_IBRAHIM_ASHAFA_STATEMENT.pdf,VALUE ADDED TAX VAT ON NIP TRANSFER FOR via GTWORLD TO IBRAHIM ASHAFA ReF GW,VALUE ADDED TAX VAT ON NIP TRANSFER FOR via GTWORLD TO IBRAHIM ASHAFA ReF GW,tax
12-Mar-2021,'0NIPG,12-Mar-2021,"5,000.00",,"121,518.16",NIBSS Instant Payment Outward 000013210312161212000037492963 via GTWORLD  TO HUSSAINI MUSA /10.75/REF:GW6819765690000000500021031216  f,SAVINGS ACCOUNT,GT_Bank,./static/raw/MR_IBRAHIM_ASHAFA_STATEMENT.pdf,NIBSS Instant Payment Outward via GTWORLD TO HUSSAINI MUSA REF GW f,NIBSS Instant Payment Outward via GTWORLD TO HUSSAINI MUSA REF GW,transfert
12-Mar-2021,'0NIPG,12-Mar-2021,10.00,,"121,508.16",COMMISSION 000013210312161212000037492963 NIP TRANSFER COMMISSION FOR 000013210312161212000037492963 via GTWORLD  TO HUSSAINI MUSA ReF:GW681976569000000050002103121610,SAVINGS ACCOUNT,GT_Bank,./static/raw/MR_IBRAHIM_ASHAFA_STATEMENT.pdf,COMMISSION NIP TRANSFER COMMISSION FOR via GTWORLD TO HUSSAINI MUSA ReF GW,COMMISSION NIP TRANSFER COMMISSION FOR via GTWORLD TO HUSSAINI MUSA ReF GW,commission
12-Mar-2021,'0NIPG,12-Mar-2021,.75,,"121,507.41",VALUE ADDED TAX 000013210312161212000037492963 VAT ON NIP TRANSFER FOR 000013210312161212000037492963 via GTWORLD  TO HUSSAINI MUSA ReF:GW681976569000000050002103121610,SAVINGS ACCOUNT,GT_Bank,./static/raw/MR_IBRAHIM_ASHAFA_STATEMENT.pdf,VALUE ADDED TAX VAT ON NIP TRANSFER FOR via GTWORLD TO HUSSAINI MUSA ReF GW,VALUE ADDED TAX VAT ON NIP TRANSFER FOR via GTWORLD TO HUSSAINI MUSA ReF GW,tax
12-Mar-2021,'0NIPG,12-Mar-2021,"8,000.00",,"113,507.41",NIBSS Instant Payment Outward 000013210312161331000037495126 via GTWORLD  TO AISHA NAMAMA ZUBAIRU /26.875/REF:GW6819765690000000800021031216 f,SAVINGS ACCOUNT,GT_Bank,./static/raw/MR_IBRAHIM_ASHAFA_STATEMENT.pdf,NIBSS Instant Payment Outward via GTWORLD TO AISHA NAMAMA ZUBAIRU REF GW f,NIBSS Instant Payment Outward via GTWORLD TO AISHA NAMAMA ZUBAIRU REF GW,transfert
12-Mar-2021,'0NIPG,12-Mar-2021,25.00,,"113,482.41",COMMISSION 000013210312161331000037495126 NIP TRANSFER COMMISSION FOR 000013210312161331000037495126 via GTWORLD  TO AISHA NAMAMA ZUBAIRU ReF:GW681976569000000080002103121612,SAVINGS ACCOUNT,GT_Bank,./static/raw/MR_IBRAHIM_ASHAFA_STATEMENT.pdf,COMMISSION NIP TRANSFER COMMISSION FOR via GTWORLD TO AISHA NAMAMA ZUBAIRU ReF GW,COMMISSION NIP TRANSFER COMMISSION FOR via GTWORLD TO AISHA NAMAMA ZUBAIRU ReF GW,commission
12-Mar-2021,'0NIPG,12-Mar-2021,1.87,,"113,480.54",VALUE ADDED TAX 000013210312161331000037495126 VAT ON NIP TRANSFER FOR 000013210312161331000037495126 via GTWORLD  TO AISHA NAMAMA ZUBAIRU ReF:GW681976569000000080002103121612,SAVINGS ACCOUNT,GT_Bank,./static/raw/MR_IBRAHIM_ASHAFA_STATEMENT.pdf,VALUE ADDED TAX VAT ON NIP TRANSFER FOR via GTWORLD TO AISHA NAMAMA ZUBAIRU ReF GW,VALUE ADDED TAX VAT ON NIP TRANSFER FOR via GTWORLD TO AISHA NAMAMA ZUBAIRU ReF GW,tax
12-Mar-2021,'0NIPG,12-Mar-2021.1,"20,000.00",,"93,480.54",NIBSS Instant Payment Outward 000013210312161526000037498214 via GTWORLD  TO IBRAHIM ABBA UMAR /26.875/REF:GW6819765690000002000021031216 f,SAVINGS ACCOUNT,GT_Bank,./static/raw/MR_IBRAHIM_ASHAFA_STATEMENT.pdf,NIBSS Instant Payment Outward via GTWORLD TO IBRAHIM ABBA UMAR REF GW f,NIBSS Instant Payment Outward via GTWORLD TO IBRAHIM ABBA UMAR REF GW,transfert
12-Mar-2021,'0NIPG,12-Mar-2021,25.00,,"93,455.54",COMMISSION 000013210312161526000037498214 NIP TRANSFER COMMISSION FOR 000013210312161526000037498214 via GTWORLD  TO IBRAHIM ABBA UMAR ReF:GW681976569000000200002103121613,SAVINGS ACCOUNT,GT_Bank,./static/raw/MR_IBRAHIM_ASHAFA_STATEMENT.pdf,COMMISSION NIP TRANSFER COMMISSION FOR via GTWORLD TO IBRAHIM ABBA UMAR ReF GW,COMMISSION NIP TRANSFER COMMISSION FOR via GTWORLD TO IBRAHIM ABBA UMAR ReF GW,commission
12-Mar-2021,'0NIPG,12-Mar-2021,1.87,,"93,453.67",VALUE ADDED TAX 000013210312161526000037498214 VAT ON NIP TRANSFER FOR 000013210312161526000037498214 via GTWORLD  TO IBRAHIM ABBA UMAR ReF:GW681976569000000200002103121613,SAVINGS ACCOUNT,GT_Bank,./static/raw/MR_IBRAHIM_ASHAFA_STATEMENT.pdf,VALUE ADDED TAX VAT ON NIP TRANSFER FOR via GTWORLD TO IBRAHIM ABBA UMAR ReF GW,VALUE ADDED TAX VAT ON NIP TRANSFER FOR via GTWORLD TO IBRAHIM ABBA UMAR ReF GW,tax
12-Mar-2021,'99990036269999,12-Mar-2021,"10,200.00",,"83,253.67",FUNDS TRANSFER  -003626- -588540-T003626 2TEPY099       LA           LANG,SAVINGS ACCOUNT,GT_Bank,./static/raw/MR_IBRAHIM_ASHAFA_STATEMENT.pdf,FUNDS TRANSFER T TEPY LA LANG,FUNDS TRANSFERTEPY LA LANG,utility
12-Mar-2021,'0NIPG,12-Mar-2021,"20,000.00",,"63,253.67",NIBSS Instant Payment Outward 000013210312184711000037758503 via GTWORLD  TO USMAN YAKUBU BABA /26.875/REF:GW6819765690000002000021031218 f,SAVINGS ACCOUNT,GT_Bank,./static/raw/MR_IBRAHIM_ASHAFA_STATEMENT.pdf,NIBSS Instant Payment Outward via GTWORLD TO USMAN YAKUBU BABA REF GW f,NIBSS Instant Payment Outward via GTWORLD TO USMAN YAKUBU BABA REF GW,transfert
12-Mar-2021,'0NIPG,12-Mar-2021,25.00,,"63,228.67",COMMISSION 000013210312184711000037758503 NIP TRANSFER COMMISSION FOR 000013210312184711000037758503 via GTWORLD  TO USMAN YAKUBU BABA ReF:GW681976569000000200002103121845,SAVINGS ACCOUNT,GT_Bank,./static/raw/MR_IBRAHIM_ASHAFA_STATEMENT.pdf,COMMISSION NIP TRANSFER COMMISSION FOR via GTWORLD TO USMAN YAKUBU BABA ReF GW,COMMISSION NIP TRANSFER COMMISSION FOR via GTWORLD TO USMAN YAKUBU BABA ReF GW,commission
12-Mar-2021,'0NIPG,12-Mar-2021,1.87,,"63,226.80",VALUE ADDED TAX 000013210312184711000037758503 VAT ON NIP TRANSFER FOR 000013210312184711000037758503 via GTWORLD  TO USMAN YAKUBU BABA ReF:GW681976569000000200002103121845,SAVINGS ACCOUNT,GT_Bank,./static/raw/MR_IBRAHIM_ASHAFA_STATEMENT.pdf,VALUE ADDED TAX VAT ON NIP TRANSFER FOR via GTWORLD TO USMAN YAKUBU BABA ReF GW,VALUE ADDED TAX VAT ON NIP TRANSFER FOR via GTWORLD TO USMAN YAKUBU BABA ReF GW,tax
12-Mar-2021,'0NIPG,12-Mar-2021,"5,000.00",,"58,226.80",NIBSS Instant Payment Outward 000013210312184859000037761314 via GTWORLD  TO ISMAILA ATTEH AUDU /10.75/REF:GW6819765690000000500021031218  f,SAVINGS ACCOUNT,GT_Bank,./static/raw/MR_IBRAHIM_ASHAFA_STATEMENT.pdf,NIBSS Instant Payment Outward via GTWORLD TO ISMAILA ATTEH AUDU REF GW f,NIBSS Instant Payment Outward via GTWORLD TO ISMAILA ATTEH AUDU REF GW,transfert
12-Mar-2021,'0NIPG,12-Mar-2021.1,10.00,,"58,216.80",COMMISSION 000013210312184859000037761314 NIP TRANSFER COMMISSION FOR 000013210312184859000037761314 via GTWORLD  TO ISMAILA ATTEH AUDU ReF:GW681976569000000050002103121847,SAVINGS ACCOUNT,GT_Bank,./static/raw/MR_IBRAHIM_ASHAFA_STATEMENT.pdf,COMMISSION NIP TRANSFER COMMISSION FOR via GTWORLD TO ISMAILA ATTEH AUDU ReF GW,COMMISSION NIP TRANSFER COMMISSION FOR via GTWORLD TO ISMAILA ATTEH AUDU ReF GW,commission
12-Mar-2021,'0NIPG,12-Mar-2021,.75,,"58,216.05",VALUE ADDED TAX 000013210312184859000037761314 VAT ON NIP TRANSFER FOR 000013210312184859000037761314 via GTWORLD  TO ISMAILA ATTEH AUDU ReF:GW681976569000000050002103121847,SAVINGS ACCOUNT,GT_Bank,./static/raw/MR_IBRAHIM_ASHAFA_STATEMENT.pdf,VALUE ADDED TAX VAT ON NIP TRANSFER FOR via GTWORLD TO ISMAILA ATTEH AUDU ReF GW,VALUE ADDED TAX VAT ON NIP TRANSFER FOR via GTWORLD TO ISMAILA ATTEH AUDU ReF GW,tax
12-Mar-2021,'0,12-Mar-2021,100.00,,"58,116.05",STAMP DUTY CHARGE 12032021 STAMP DUTY CHARGE - 12/03/2021,SAVINGS ACCOUNT,GT_Bank,./static/raw/MR_IBRAHIM_ASHAFA_STATEMENT.pdf,STAMP DUTY CHARGE STAMP DUTY CHARGE,STAMP DUTY CHARGE STAMP DUTY CHARGE,bank_charges
13-Mar-2021,'0USAT,13-Mar-2021,"1,000.00",,"57,116.05",Airtime Purchase GTWORLD_QL- 101CT0000000002436132270-2348038673032,SAVINGS ACCOUNT,GT_Bank,./static/raw/MR_IBRAHIM_ASHAFA_STATEMENT.pdf,Airtime Purchase GTWORLD_QL CT,Airtime Purchase GTWORLDQL CT,utility
13-Mar-2021,'0NIPT,13-Mar-2021,,"20,000.00","77,116.05",TRANSFER BETWEEN CUSTOMERS 000004210313092109043731992256|MOB/UTO/738 0604749/000013/Fin support|7380604749||LABARAN MAGAJI SHUAIBU REF:000004210313092109043731992256,SAVINGS ACCOUNT,GT_Bank,./static/raw/MR_IBRAHIM_ASHAFA_STATEMENT.pdf,TRANSFER BETWEEN CUSTOMERS MOB UTO Fin support LABARAN MAGAJI SHUAIBU REF,TRANSFER BETWEEN CUSTOMERS MOB UTO Fin support LABARAN MAGAJI SHUAIBU REF,transfert
13-Mar-2021,'0NIPG,13-Mar-2021,"1,500.00",,"75,616.05",NIBSS Instant Payment Outward 000013210313114926000038480707 via GTWORLD  TO MUHAMMED FAISAL ALIYU /10.75/REF:GW6819765690000000150021031311  f,SAVINGS ACCOUNT,GT_Bank,./static/raw/MR_IBRAHIM_ASHAFA_STATEMENT.pdf,NIBSS Instant Payment Outward via GTWORLD TO MUHAMMED FAISAL ALIYU REF GW f,NIBSS Instant Payment Outward via GTWORLD TO MUHAMMED FAISAL ALIYU REF GW,transfert
13-Mar-2021,'0NIPG,13-Mar-2021,10.00,,"75,606.05",COMMISSION 000013210313114926000038480707 NIP TRANSFER COMMISSION FOR 000013210313114926000038480707 via GTWORLD  TO MUHAMMED FAISAL ALIYU ReF:GW681976569000000015002103131147,SAVINGS ACCOUNT,GT_Bank,./static/raw/MR_IBRAHIM_ASHAFA_STATEMENT.pdf,COMMISSION NIP TRANSFER COMMISSION FOR via GTWORLD TO MUHAMMED FAISAL ALIYU ReF GW,COMMISSION NIP TRANSFER COMMISSION FOR via GTWORLD TO MUHAMMED FAISAL ALIYU ReF GW,commission
13-Mar-2021,'0NIPG,13-Mar-2021,.75,,"75,605.30",VALUE ADDED TAX 000013210313114926000038480707 VAT ON NIP TRANSFER FOR 000013210313114926000038480707 via GTWORLD  TO MUHAMMED FAISAL ALIYU ReF:GW681976569000000015002103131147,SAVINGS ACCOUNT,GT_Bank,./static/raw/MR_IBRAHIM_ASHAFA_STATEMENT.pdf,VALUE ADDED TAX VAT ON NIP TRANSFER FOR via GTWORLD TO MUHAMMED FAISAL ALIYU ReF GW,VALUE ADDED TAX VAT ON NIP TRANSFER FOR via GTWORLD TO MUHAMMED FAISAL ALIYU ReF GW,tax
13-Mar-2021,'0GWTR,13-Mar-2021,"10,000.00",,"65,605.30",TRANSFER BETWEEN CUSTOMERS Via GTWorld REF:681976569000000100002103131301  from ASHAFA IBRAHIM ABDULLAHI  to  MUHAMMADISMAIL RABO,SAVINGS ACCOUNT,GT_Bank,./static/raw/MR_IBRAHIM_ASHAFA_STATEMENT.pdf,TRANSFER BETWEEN CUSTOMERS Via GTWorld REF from ASHAFA IBRAHIM ABDULLAHI to MUHAMMADISMAIL RABO,TRANSFER BETWEEN CUSTOMERS Via GTWorld REF from ASHAFA IBRAHIM ABDULLAHI to MUHAMMADISMAIL RABO,transfert
13-Mar-2021,'99990051209999,13-Mar-2021,"5,100.00",,"60,505.30",FUNDS TRANSFER  -005120- -270969-T005120 2TGT1393       LA           LANG,SAVINGS ACCOUNT,GT_Bank,./static/raw/MR_IBRAHIM_ASHAFA_STATEMENT.pdf,FUNDS TRANSFER T TGT LA LANG,FUNDS TRANSFERTGT LA LANG,utility
13-Mar-2021,'0NIPG,13-Mar-2021,"5,000.00",,"55,505.30",NIBSS Instant Payment Outward 000013210313210951000039295454 via GTWORLD  TO JIBRIN BASIRAH USMAN /10.75/REF:GW6819765690000000500021031321  f,SAVINGS ACCOUNT,GT_Bank,./static/raw/MR_IBRAHIM_ASHAFA_STATEMENT.pdf,NIBSS Instant Payment Outward via GTWORLD TO JIBRIN BASIRAH USMAN REF GW f,NIBSS Instant Payment Outward via GTWORLD TO JIBRIN BASIRAH USMAN REF GW,transfert
13-Mar-2021,'0NIPG,13-Mar-2021,10.00,,"55,495.30",COMMISSION 000013210313210951000039295454 NIP TRANSFER COMMISSION FOR 000013210313210951000039295454 via GTWORLD  TO JIBRIN BASIRAH USMAN ReF:GW681976569000000050002103132108,SAVINGS ACCOUNT,GT_Bank,./static/raw/MR_IBRAHIM_ASHAFA_STATEMENT.pdf,COMMISSION NIP TRANSFER COMMISSION FOR via GTWORLD TO JIBRIN BASIRAH USMAN ReF GW,COMMISSION NIP TRANSFER COMMISSION FOR via GTWORLD TO JIBRIN BASIRAH USMAN ReF GW,commission
13-Mar-2021,'0NIPG,13-Mar-2021,.75,,"55,494.55",VALUE ADDED TAX 000013210313210951000039295454 VAT ON NIP TRANSFER FOR 000013210313210951000039295454 via GTWORLD  TO JIBRIN BASIRAH USMAN ReF:GW681976569000000050002103132108,SAVINGS ACCOUNT,GT_Bank,./static/raw/MR_IBRAHIM_ASHAFA_STATEMENT.pdf,VALUE ADDED TAX VAT ON NIP TRANSFER FOR via GTWORLD TO JIBRIN BASIRAH USMAN ReF GW,VALUE ADDED TAX VAT ON NIP TRANSFER FOR via GTWORLD TO JIBRIN BASIRAH USMAN ReF GW,tax
13-Mar-2021,'0,13-Mar-2021,50.00,,"55,444.55",STAMP DUTY CHARGE 13032021 STAMP DUTY CHARGE - 13/03/2021,SAVINGS ACCOUNT,GT_Bank,./static/raw/MR_IBRAHIM_ASHAFA_STATEMENT.pdf,STAMP DUTY CHARGE STAMP DUTY CHARGE,STAMP DUTY CHARGE STAMP DUTY CHARGE,bank_charges
14-Mar-2021,'47460000,14-Mar-2021,"10,000.00",,"45,444.55",POS/WEB PURCHASE TRANSACTION  -004746- - 086820-A.Y.M. SHAFA LIMITED A.NA           LANG,SAVINGS ACCOUNT,GT_Bank,./static/raw/MR_IBRAHIM_ASHAFA_STATEMENT.pdf,POS WEB PURCHASE TRANSACTION A Y M SHAFA LIMITED A NA LANG,POS WEB PURCHASE TRANSACTIONYSHAFA LIMITEDNA LANG,utility
14-Mar-2021,'99998880229999,14-Mar-2021,35.00,,"45,409.55",ATM WITHDRAWAL COMMISSION  -888022- - 558206-ACCESS BANK00000000000 ABUJA NG,SAVINGS ACCOUNT,GT_Bank,./static/raw/MR_IBRAHIM_ASHAFA_STATEMENT.pdf,ATM WITHDRAWAL COMMISSION ACCESS BANK ABUJA NG,ATM WITHDRAWAL COMMISSION ACCESS BANK ABUJA NG,cash
14-Mar-2021,'99998880229999,14-Mar-2021,"5,000.00",,"40,409.55",CASH WITHDRAWAL FROM OTHER ATM  - 888022- -558206-ACCESS BANK00000000000 ABUJA          NG,SAVINGS ACCOUNT,GT_Bank,./static/raw/MR_IBRAHIM_ASHAFA_STATEMENT.pdf,CASH WITHDRAWAL FROM OTHER ATM ACCESS BANK ABUJA NG,CASH WITHDRAWAL FROM OTHER ATM ACCESS BANK ABUJA NG,cash
15-Mar-2021,'0NIPG,15-Mar-2021,"3,000.00",,"37,409.55",NIBSS Instant Payment Outward 000013210315084344000040524768 via GTWORLD  TO HASSAN MANSUR RAMALAN /10.75/REF:GW6819765690000000300021031508  f,SAVINGS ACCOUNT,GT_Bank,./static/raw/MR_IBRAHIM_ASHAFA_STATEMENT.pdf,NIBSS Instant Payment Outward via GTWORLD TO HASSAN MANSUR RAMALAN REF GW f,NIBSS Instant Payment Outward via GTWORLD TO HASSAN MANSUR RAMALAN REF GW,transfert
15-Mar-2021,'0NIPG,15-Mar-2021,10.00,,"37,399.55",COMMISSION 000013210315084344000040524768 NIP TRANSFER COMMISSION FOR 000013210315084344000040524768 via GTWORLD  TO HASSAN MANSUR RAMALAN ReF:GW681976569000000030002103150842,SAVINGS ACCOUNT,GT_Bank,./static/raw/MR_IBRAHIM_ASHAFA_STATEMENT.pdf,COMMISSION NIP TRANSFER COMMISSION FOR via GTWORLD TO HASSAN MANSUR RAMALAN ReF GW,COMMISSION NIP TRANSFER COMMISSION FOR via GTWORLD TO HASSAN MANSUR RAMALAN ReF GW,commission
15-Mar-2021,'0NIPG,15-Mar-2021.1,.75,,"37,398.80",VALUE ADDED TAX 000013210315084344000040524768 VAT ON NIP TRANSFER FOR 000013210315084344000040524768 via GTWORLD  TO HASSAN MANSUR RAMALAN ReF:GW681976569000000030002103150842,SAVINGS ACCOUNT,GT_Bank,./static/raw/MR_IBRAHIM_ASHAFA_STATEMENT.pdf,VALUE ADDED TAX VAT ON NIP TRANSFER FOR via GTWORLD TO HASSAN MANSUR RAMALAN ReF GW,VALUE ADDED TAX VAT ON NIP TRANSFER FOR via GTWORLD TO HASSAN MANSUR RAMALAN ReF GW,tax
15-Mar-2021,'0GWTR,15-Mar-2021,"3,000.00",,"34,398.80","TRANSFER BETWEEN CUSTOMERS Via GTWorld REF:681976569000000030002103151438  from ASHAFA IBRAHIM ABDULLAHI  to  ALI, MOHAMMED KENAH",SAVINGS ACCOUNT,GT_Bank,./static/raw/MR_IBRAHIM_ASHAFA_STATEMENT.pdf,TRANSFER BETWEEN CUSTOMERS Via GTWorld REF from ASHAFA IBRAHIM ABDULLAHI to ALI MOHAMMED KENAH,TRANSFER BETWEEN CUSTOMERS Via GTWorld REF from ASHAFA IBRAHIM ABDULLAHI to ALI MOHAMMED KENAH,transfert
15-Mar-2021,'0GWTR,15-Mar-2021,"4,000.00",,"30,398.80",TRANSFER BETWEEN CUSTOMERS Via GTWorld REF:681976569000000040002103151438  from ASHAFA IBRAHIM ABDULLAHI  to  MUHAMMAD ISMAIL RABO,SAVINGS ACCOUNT,GT_Bank,./static/raw/MR_IBRAHIM_ASHAFA_STATEMENT.pdf,TRANSFER BETWEEN CUSTOMERS Via GTWorld REF from ASHAFA IBRAHIM ABDULLAHI to MUHAMMAD ISMAIL RABO,TRANSFER BETWEEN CUSTOMERS Via GTWorld REF from ASHAFA IBRAHIM ABDULLAHI to MUHAMMAD ISMAIL RABO,transfert
15-Mar-2021,'0NIPT,15-Mar-2021,,"450,000.00","480,398.80",TRANSFER BETWEEN CUSTOMERS 000014210315163207229534021609|TRF/SD10 house 1 /FRM MADU BATA MADA298796 TO ASHAFA|VNM9344266693968025||MADU BATA MADA298796 REF:000014210315163207229534021609,SAVINGS ACCOUNT,GT_Bank,./static/raw/MR_IBRAHIM_ASHAFA_STATEMENT.pdf,TRANSFER BETWEEN CUSTOMERS TRF SD house FRM MADU BATA MADA TO ASHAFA VNM MADU BATA MADA REF,TRANSFER BETWEEN CUSTOMERS TRF SD house FRM MADU BATA MADA TO ASHAFA VNM MADU BATA MADA REF,transfert
15-Mar-2021,'0NIPG,15-Mar-2021,"20,000.00",,"460,398.80",NIBSS Instant Payment Outward 000013210315163556000041310356 via GTWORLD  TO ABUBAKAR ABDULRAKIB /26.875/REF:GW6819765690000002000021031516 f,SAVINGS ACCOUNT,GT_Bank,./static/raw/MR_IBRAHIM_ASHAFA_STATEMENT.pdf,NIBSS Instant Payment Outward via GTWORLD TO ABUBAKAR ABDULRAKIB REF GW f,NIBSS Instant Payment Outward via GTWORLD TO ABUBAKAR ABDULRAKIB REF GW,transfert
15-Mar-2021,'0NIPG,15-Mar-2021,25.00,,"460,373.80",COMMISSION 000013210315163556000041310356 NIP TRANSFER COMMISSION FOR 000013210315163556000041310356 via GTWORLD  TO ABUBAKAR ABDULRAKIB ReF:GW681976569000000200002103151634,SAVINGS ACCOUNT,GT_Bank,./static/raw/MR_IBRAHIM_ASHAFA_STATEMENT.pdf,COMMISSION NIP TRANSFER COMMISSION FOR via GTWORLD TO ABUBAKAR ABDULRAKIB ReF GW,COMMISSION NIP TRANSFER COMMISSION FOR via GTWORLD TO ABUBAKAR ABDULRAKIB ReF GW,commission
15-Mar-2021,'0NIPG,15-Mar-2021,1.87,,"460,371.93",VALUE ADDED TAX 000013210315163556000041310356 VAT ON NIP TRANSFER FOR 000013210315163556000041310356 via GTWORLD  TO ABUBAKAR ABDULRAKIB ReF:GW681976569000000200002103151634,SAVINGS ACCOUNT,GT_Bank,./static/raw/MR_IBRAHIM_ASHAFA_STATEMENT.pdf,VALUE ADDED TAX VAT ON NIP TRANSFER FOR via GTWORLD TO ABUBAKAR ABDULRAKIB ReF GW,VALUE ADDED TAX VAT ON NIP TRANSFER FOR via GTWORLD TO ABUBAKAR ABDULRAKIB ReF GW,tax
15-Mar-2021,'0NIPG,15-Mar-2021,"290,000.00",,"170,371.93",NIBSS Instant Payment Outward 000013210315163633000041311491 via GTWORLD  TO ASHAFA USMAN ABDULLAHI/53.75/REF:GW6819765690000029000021031516  f,SAVINGS ACCOUNT,GT_Bank,./static/raw/MR_IBRAHIM_ASHAFA_STATEMENT.pdf,NIBSS Instant Payment Outward via GTWORLD TO ASHAFA USMAN ABDULLAHI REF GW f,NIBSS Instant Payment Outward via GTWORLD TO ASHAFA USMAN ABDULLAHI REF GW,transfert
15-Mar-2021,'0NIPG,15-Mar-2021,50.00,,"170,321.93",COMMISSION 000013210315163633000041311491 NIP TRANSFER COMMISSION FOR 000013210315163633000041311491 via GTWORLD  TO ASHAFA USMAN ABDULLAHI ReF:GW681976569000002900002103151635,SAVINGS ACCOUNT,GT_Bank,./static/raw/MR_IBRAHIM_ASHAFA_STATEMENT.pdf,COMMISSION NIP TRANSFER COMMISSION FOR via GTWORLD TO ASHAFA USMAN ABDULLAHI ReF GW,COMMISSION NIP TRANSFER COMMISSION FOR via GTWORLD TO ASHAFA USMAN ABDULLAHI ReF GW,commission
15-Mar-2021,'0NIPG,15-Mar-2021,3.75,,"170,318.18",VALUE ADDED TAX 000013210315163633000041311491 VAT ON NIP TRANSFER FOR 000013210315163633000041311491 via GTWORLD  TO ASHAFA USMAN ABDULLAHI ReF:GW681976569000002900002103151635,SAVINGS ACCOUNT,GT_Bank,./static/raw/MR_IBRAHIM_ASHAFA_STATEMENT.pdf,VALUE ADDED TAX VAT ON NIP TRANSFER FOR via GTWORLD TO ASHAFA USMAN ABDULLAHI ReF GW,VALUE ADDED TAX VAT ON NIP TRANSFER FOR via GTWORLD TO ASHAFA USMAN ABDULLAHI ReF GW,tax
15-Mar-2021,'0GWTR,15-Mar-2021,"2,000.00",,"168,318.18",TRANSFER BETWEEN CUSTOMERS Via GTWorld REF:681976569000000020002103151645  from ASHAFA IBRAHIM ABDULLAHI  to  MUHAMMAD ISMAIL RABO,SAVINGS ACCOUNT,GT_Bank,./static/raw/MR_IBRAHIM_ASHAFA_STATEMENT.pdf,TRANSFER BETWEEN CUSTOMERS Via GTWorld REF from ASHAFA IBRAHIM ABDULLAHI to MUHAMMAD ISMAIL RABO,TRANSFER BETWEEN CUSTOMERS Via GTWorld REF from ASHAFA IBRAHIM ABDULLAHI to MUHAMMAD ISMAIL RABO,transfert
15-Mar-2021,'0NIPG,15-Mar-2021,"3,000.00",,"165,318.18",NIBSS Instant Payment Outward 000013210315164746000041331544 via GTWORLD  TO YUSUF HASSAN /10.75/REF:GW6819765690000000300021031516  f,SAVINGS ACCOUNT,GT_Bank,./static/raw/MR_IBRAHIM_ASHAFA_STATEMENT.pdf,NIBSS Instant Payment Outward via GTWORLD TO YUSUF HASSAN REF GW f,NIBSS Instant Payment Outward via GTWORLD TO YUSUF HASSAN REF GW,transfert
15-Mar-2021,'0NIPG,15-Mar-2021,10.00,,"165,308.18",COMMISSION 000013210315164746000041331544 NIP TRANSFER COMMISSION FOR 000013210315164746000041331544 via GTWORLD  TO YUSUF HASSAN ReF:GW681976569000000030002103151646,SAVINGS ACCOUNT,GT_Bank,./static/raw/MR_IBRAHIM_ASHAFA_STATEMENT.pdf,COMMISSION NIP TRANSFER COMMISSION FOR via GTWORLD TO YUSUF HASSAN ReF GW,COMMISSION NIP TRANSFER COMMISSION FOR via GTWORLD TO YUSUF HASSAN ReF GW,commission
15-Mar-2021,'0NIPG,15-Mar-2021,.75,,"165,307.43",VALUE ADDED TAX 000013210315164746000041331544 VAT ON NIP TRANSFER FOR 000013210315164746000041331544 via GTWORLD  TO YUSUF HASSAN ReF:GW681976569000000030002103151646,SAVINGS ACCOUNT,GT_Bank,./static/raw/MR_IBRAHIM_ASHAFA_STATEMENT.pdf,VALUE ADDED TAX VAT ON NIP TRANSFER FOR via GTWORLD TO YUSUF HASSAN ReF GW,VALUE ADDED TAX VAT ON NIP TRANSFER FOR via GTWORLD TO YUSUF HASSAN ReF GW,tax
15-Mar-2021,'0NIPG,15-Mar-2021,"20,000.00",,"145,307.43",NIBSS Instant Payment Outward 000013210315164819000041332528 via GTWORLD  TO ALIYU HAUWA /26.875/REF:GW6819765690000002000021031516 f,SAVINGS ACCOUNT,GT_Bank,./static/raw/MR_IBRAHIM_ASHAFA_STATEMENT.pdf,NIBSS Instant Payment Outward via GTWORLD TO ALIYU HAUWA REF GW f,NIBSS Instant Payment Outward via GTWORLD TO ALIYU HAUWA REF GW,transfert
15-Mar-2021,'0NIPG,15-Mar-2021,25.00,,"145,282.43",COMMISSION 000013210315164819000041332528 NIP TRANSFER COMMISSION FOR000013210315164819000041332528 via GTWORLD  TO ALIYU HAUWA ReF:GW681976569000000200002103151646,SAVINGS ACCOUNT,GT_Bank,./static/raw/MR_IBRAHIM_ASHAFA_STATEMENT.pdf,COMMISSION NIP TRANSFER COMMISSION FOR via GTWORLD TO ALIYU HAUWA ReF GW,COMMISSION NIP TRANSFER COMMISSION FOR via GTWORLD TO ALIYU HAUWA ReF GW,commission
15-Mar-2021,'0NIPG,15-Mar-2021,1.87,,"145,280.56",VALUE ADDED TAX 000013210315164819000041332528 VAT ON NIP TRANSFER FOR 000013210315164819000041332528 via GTWORLD  TO ALIYU HAUWA ReF:GW681976569000000200002103151646,SAVINGS ACCOUNT,GT_Bank,./static/raw/MR_IBRAHIM_ASHAFA_STATEMENT.pdf,VALUE ADDED TAX VAT ON NIP TRANSFER FOR via GTWORLD TO ALIYU HAUWA ReF GW,VALUE ADDED TAX VAT ON NIP TRANSFER FOR via GTWORLD TO ALIYU HAUWA ReF GW,tax
15-Mar-2021,'0NIPG,15-Mar-2021,"20,000.00",,"125,280.56",NIBSS Instant Payment Outward 000013210315164917000041334347 via GTWORLD  TO DEMIDE ENEYAMIRE JEMILATU /26.875/REF:GW6819765690000002000021031516 f,SAVINGS ACCOUNT,GT_Bank,./static/raw/MR_IBRAHIM_ASHAFA_STATEMENT.pdf,NIBSS Instant Payment Outward via GTWORLD TO DEMIDE ENEYAMIRE JEMILATU REF GW f,NIBSS Instant Payment Outward via GTWORLD TO DEMIDE ENEYAMIRE JEMILATU REF GW,transfert
15-Mar-2021,'0NIPG,15-Mar-2021,25.00,,"125,255.56",COMMISSION 000013210315164917000041334347 NIP TRANSFER COMMISSION FOR 000013210315164917000041334347 via GTWORLD  TO DEMIDE ENEYAMIRE JEMILATU ReF:GW681976569000000200002103151647,SAVINGS ACCOUNT,GT_Bank,./static/raw/MR_IBRAHIM_ASHAFA_STATEMENT.pdf,COMMISSION NIP TRANSFER COMMISSION FOR via GTWORLD TO DEMIDE ENEYAMIRE JEMILATU ReF GW,COMMISSION NIP TRANSFER COMMISSION FOR via GTWORLD TO DEMIDE ENEYAMIRE JEMILATU ReF GW,commission
15-Mar-2021,'0NIPG,15-Mar-2021,1.87,,"125,253.69",VALUE ADDED TAX 000013210315164917000041334347 VAT ON NIP TRANSFER FOR 000013210315164917000041334347 via GTWORLD  TO DEMIDE ENEYAMIRE JEMILATU ReF:GW681976569000000200002103151647,SAVINGS ACCOUNT,GT_Bank,./static/raw/MR_IBRAHIM_ASHAFA_STATEMENT.pdf,VALUE ADDED TAX VAT ON NIP TRANSFER FOR via GTWORLD TO DEMIDE ENEYAMIRE JEMILATU ReF GW,VALUE ADDED TAX VAT ON NIP TRANSFER FOR via GTWORLD TO DEMIDE ENEYAMIRE JEMILATU ReF GW,tax
15-Mar-2021,'0GWTR,15-Mar-2021,"1,500.00",,"123,753.69",TRANSFER BETWEEN CUSTOMERS Via GTWorld REF:681976569000000015002103151823  from ASHAFA IBRAHIM ABDULLAHI  to  AUTA WILLIAMS,SAVINGS ACCOUNT,GT_Bank,./static/raw/MR_IBRAHIM_ASHAFA_STATEMENT.pdf,TRANSFER BETWEEN CUSTOMERS Via GTWorld REF from ASHAFA IBRAHIM ABDULLAHI to AUTA WILLIAMS,TRANSFER BETWEEN CUSTOMERS Via GTWorld REF from ASHAFA IBRAHIM ABDULLAHI to AUTA WILLIAMS,transfert
15-Mar-2021,'0USAT,15-Mar-2021,500.00,,"123,253.69",Airtime Purchase GTWORLD- 101CT0000000002441941047-2347060637979,SAVINGS ACCOUNT,GT_Bank,./static/raw/MR_IBRAHIM_ASHAFA_STATEMENT.pdf,Airtime Purchase GTWORLD CT,Airtime Purchase GTWORLD CT,utility
15-Mar-2021,'0NIPG,15-Mar-2021,"8,000.00",,"115,253.69",NIBSS Instant Payment Outward 000013210315182653000041506944 via GTWORLD  TO DALHATU ABDULLAHI ASHAFA /26.875/REF:GW6819765690000000800021031518 f,SAVINGS ACCOUNT,GT_Bank,./static/raw/MR_IBRAHIM_ASHAFA_STATEMENT.pdf,NIBSS Instant Payment Outward via GTWORLD TO DALHATU ABDULLAHI ASHAFA REF GW f,NIBSS Instant Payment Outward via GTWORLD TO DALHATU ABDULLAHI ASHAFA REF GW,transfert
15-Mar-2021,'0NIPG,15-Mar-2021,25.00,,"115,228.69",COMMISSION 000013210315182653000041506944 NIP TRANSFER COMMISSION FOR000013210315182653000041506944 via GTWORLD  TO DALHATU ABDULLAHI ASHAFA ReF:GW681976569000000080002103151825,SAVINGS ACCOUNT,GT_Bank,./static/raw/MR_IBRAHIM_ASHAFA_STATEMENT.pdf,COMMISSION NIP TRANSFER COMMISSION FOR via GTWORLD TO DALHATU ABDULLAHI ASHAFA ReF GW,COMMISSION NIP TRANSFER COMMISSION FOR via GTWORLD TO DALHATU ABDULLAHI ASHAFA ReF GW,commission
15-Mar-2021,'0NIPG,15-Mar-2021,1.87,,"115,226.82",VALUE ADDED TAX 000013210315182653000041506944 VAT ON NIP TRANSFER FOR 000013210315182653000041506944 via GTWORLD  TO DALHATU ABDULLAHI ASHAFA ReF:GW681976569000000080002103151825,SAVINGS ACCOUNT,GT_Bank,./static/raw/MR_IBRAHIM_ASHAFA_STATEMENT.pdf,VALUE ADDED TAX VAT ON NIP TRANSFER FOR via GTWORLD TO DALHATU ABDULLAHI ASHAFA ReF GW,VALUE ADDED TAX VAT ON NIP TRANSFER FOR via GTWORLD TO DALHATU ABDULLAHI ASHAFA ReF GW,tax
15-Mar-2021,'0USAT,15-Mar-2021,"1,000.00",,"114,226.82",Airtime Purchase GTWORLD- 101CT0000000002441955138-2348038673032,SAVINGS ACCOUNT,GT_Bank,./static/raw/MR_IBRAHIM_ASHAFA_STATEMENT.pdf,Airtime Purchase GTWORLD CT,Airtime Purchase GTWORLD CT,utility
15-Mar-2021,'0NIPG,15-Mar-2021,"4,000.00",,"110,226.82",NIBSS Instant Payment Outward 000013210315183146000041515772 via GTWORLD  TO YOHANA ANITA AFINIKI /10.75/REF:GW6819765690000000400021031518  f,SAVINGS ACCOUNT,GT_Bank,./static/raw/MR_IBRAHIM_ASHAFA_STATEMENT.pdf,NIBSS Instant Payment Outward via GTWORLD TO YOHANA ANITA AFINIKI REF GW f,NIBSS Instant Payment Outward via GTWORLD TO YOHANA ANITA AFINIKI REF GW,transfert
15-Mar-2021,'0NIPG,15-Mar-2021,10.00,,"110,216.82",COMMISSION 000013210315183146000041515772 NIP TRANSFER COMMISSION FOR 000013210315183146000041515772 via GTWORLD  TO YOHANA ANITA AFINIKI ReF:GW681976569000000040002103151830,SAVINGS ACCOUNT,GT_Bank,./static/raw/MR_IBRAHIM_ASHAFA_STATEMENT.pdf,COMMISSION NIP TRANSFER COMMISSION FOR via GTWORLD TO YOHANA ANITA AFINIKI ReF GW,COMMISSION NIP TRANSFER COMMISSION FOR via GTWORLD TO YOHANA ANITA AFINIKI ReF GW,commission
15-Mar-2021,'0NIPG,15-Mar-2021,.75,,"110,216.07",VALUE ADDED TAX 000013210315183146000041515772 VAT ON NIP TRANSFER FOR 000013210315183146000041515772 via GTWORLD  TO YOHANA ANITA AFINIKI ReF:GW681976569000000040002103151830,SAVINGS ACCOUNT,GT_Bank,./static/raw/MR_IBRAHIM_ASHAFA_STATEMENT.pdf,VALUE ADDED TAX VAT ON NIP TRANSFER FOR via GTWORLD TO YOHANA ANITA AFINIKI ReF GW,VALUE ADDED TAX VAT ON NIP TRANSFER FOR via GTWORLD TO YOHANA ANITA AFINIKI ReF GW,tax
15-Mar-2021,'0NIPG,15-Mar-2021,"1,000.00",,"109,216.07",NIBSS Instant Payment Outward 000013210315211326000041738823 via GTWORLD  TO DALHATU ABDULLAHI ASHAFA /10.75/REF:GW6819765690000000100021031521  f,SAVINGS ACCOUNT,GT_Bank,./static/raw/MR_IBRAHIM_ASHAFA_STATEMENT.pdf,NIBSS Instant Payment Outward via GTWORLD TO DALHATU ABDULLAHI ASHAFA REF GW f,NIBSS Instant Payment Outward via GTWORLD TO DALHATU ABDULLAHI ASHAFA REF GW,transfert
15-Mar-2021,'0NIPG,15-Mar-2021,10.00,,"109,206.07",COMMISSION 000013210315211326000041738823 NIP TRANSFER COMMISSION FOR 000013210315211326000041738823 via GTWORLD  TO DALHATU ABDULLAHI ASHAFA ReF:GW681976569000000010002103152111,SAVINGS ACCOUNT,GT_Bank,./static/raw/MR_IBRAHIM_ASHAFA_STATEMENT.pdf,COMMISSION NIP TRANSFER COMMISSION FOR via GTWORLD TO DALHATU ABDULLAHI ASHAFA ReF GW,COMMISSION NIP TRANSFER COMMISSION FOR via GTWORLD TO DALHATU ABDULLAHI ASHAFA ReF GW,commission
15-Mar-2021,'0NIPG,15-Mar-2021,.75,,"109,205.32",VALUE ADDED TAX 000013210315211326000041738823 VAT ON NIP TRANSFER FOR000013210315211326000041738823 via GTWORLD  TO DALHATU ABDULLAHI ASHAFA ReF:GW681976569000000010002103152111,SAVINGS ACCOUNT,GT_Bank,./static/raw/MR_IBRAHIM_ASHAFA_STATEMENT.pdf,VALUE ADDED TAX VAT ON NIP TRANSFER FOR via GTWORLD TO DALHATU ABDULLAHI ASHAFA ReF GW,VALUE ADDED TAX VAT ON NIP TRANSFER FOR via GTWORLD TO DALHATU ABDULLAHI ASHAFA ReF GW,tax
15-Mar-2021,'0USAT,15-Mar-2021,"1,000.00",,"108,205.32",Airtime Purchase GTWORLD_QL- 101CT0000000002442380654-2348030549818,SAVINGS ACCOUNT,GT_Bank,./static/raw/MR_IBRAHIM_ASHAFA_STATEMENT.pdf,Airtime Purchase GTWORLD_QL CT,Airtime Purchase GTWORLDQL CT,utility
16-Mar-2021,'0,15-Mar-2021,50.00,,"108,155.32",STAMP DUTY CHARGE 15032021 STAMP DUTY CHARGE - 15/03/2021,SAVINGS ACCOUNT,GT_Bank,./static/raw/MR_IBRAHIM_ASHAFA_STATEMENT.pdf,STAMP DUTY CHARGE STAMP DUTY CHARGE,STAMP DUTY CHARGE STAMP DUTY CHARGE,bank_charges
16-Mar-2021,'0USAT,16-Mar-2021,"1,000.00",,"107,155.32",Airtime Purchase GTWORLD_QL- 101CT0000000002444029121-2348038673032,SAVINGS ACCOUNT,GT_Bank,./static/raw/MR_IBRAHIM_ASHAFA_STATEMENT.pdf,Airtime Purchase GTWORLD_QL CT,Airtime Purchase GTWORLDQL CT,utility
16-Mar-2021,'0GWTR,16-Mar-2021,"4,000.00",,"103,155.32","TRANSFER BETWEEN CUSTOMERS Via GTWorld REF:681976569000000040002103161544  from ASHAFA IBRAHIM ABDULLAHI  to  AMADI , VIVIAN AMARACHI",SAVINGS ACCOUNT,GT_Bank,./static/raw/MR_IBRAHIM_ASHAFA_STATEMENT.pdf,TRANSFER BETWEEN CUSTOMERS Via GTWorld REF from ASHAFA IBRAHIM ABDULLAHI to AMADI VIVIAN AMARACHI,TRANSFER BETWEEN CUSTOMERS Via GTWorld REF from ASHAFA IBRAHIM ABDULLAHI to AMADI VIVIAN AMARACHI,transfert
16-Mar-2021,'99990115219999,16-Mar-2021,100.00,,"103,055.32",PURCHASE/TRANSFER COMMISSION  -011521- - 040932-WT|SHEHU HAJIYA REKIYA          ABUJA NG,SAVINGS ACCOUNT,GT_Bank,./static/raw/MR_IBRAHIM_ASHAFA_STATEMENT.pdf,PURCHASE TRANSFER COMMISSION WT SHEHU HAJIYA REKIYA ABUJA NG,PURCHASE TRANSFER COMMISSION WT SHEHU HAJIYA REKIYA ABUJA NG,transfert
16-Mar-2021,'99990115219999,16-Mar-2021,"3,000.00",,"100,055.32",ATM/POS ACOUNT TO ACCOUNT TRANSFER  - 011521- -040932-WT|SHEHU HAJIYA REKIYA ABUJA NG,SAVINGS ACCOUNT,GT_Bank,./static/raw/MR_IBRAHIM_ASHAFA_STATEMENT.pdf,ATM POS ACOUNT TO ACCOUNT TRANSFER WT SHEHU HAJIYA REKIYA ABUJA NG,ATM POS ACOUNT TO ACCOUNT TRANSFER WT SHEHU HAJIYA REKIYA ABUJA NG,transfert
17-Mar-2021,'0NIPG,17-Mar-2021,"50,000.00",,"50,055.32",NIBSS Instant Payment Outward 000013210317103417000043696003 via GTWORLD  TO HUSSAINI MUSA /26.875/REF:GW6819765690000005000021031710 f,SAVINGS ACCOUNT,GT_Bank,./static/raw/MR_IBRAHIM_ASHAFA_STATEMENT.pdf,NIBSS Instant Payment Outward via GTWORLD TO HUSSAINI MUSA REF GW f,NIBSS Instant Payment Outward via GTWORLD TO HUSSAINI MUSA REF GW,transfert
17-Mar-2021,'0NIPG,17-Mar-2021,25.00,,"50,030.32",COMMISSION 000013210317103417000043696003 NIP TRANSFER COMMISSION FOR 000013210317103417000043696003 via GTWORLD  TO HUSSAINI MUSA ReF:GW681976569000000500002103171032,SAVINGS ACCOUNT,GT_Bank,./static/raw/MR_IBRAHIM_ASHAFA_STATEMENT.pdf,COMMISSION NIP TRANSFER COMMISSION FOR via GTWORLD TO HUSSAINI MUSA ReF GW,COMMISSION NIP TRANSFER COMMISSION FOR via GTWORLD TO HUSSAINI MUSA ReF GW,commission
17-Mar-2021,'0NIPG,17-Mar-2021,1.87,,"50,028.45",VALUE ADDED TAX 000013210317103417000043696003 VAT ON NIP TRANSFER FOR 000013210317103417000043696003 via GTWORLD  TO HUSSAINI MUSA ReF:GW681976569000000500002103171032,SAVINGS ACCOUNT,GT_Bank,./static/raw/MR_IBRAHIM_ASHAFA_STATEMENT.pdf,VALUE ADDED TAX VAT ON NIP TRANSFER FOR via GTWORLD TO HUSSAINI MUSA ReF GW,VALUE ADDED TAX VAT ON NIP TRANSFER FOR via GTWORLD TO HUSSAINI MUSA ReF GW,tax
17-Mar-2021,'0NIPG,17-Mar-2021,"10,000.00",,"40,028.45",NIBSS Instant Payment Outward 000013210317154218000044204956 viaGTWORLD  TO JAAFAR I AKUMA/26.875/REF:GW6819765690000001000021031715f,SAVINGS ACCOUNT,GT_Bank,./static/raw/MR_IBRAHIM_ASHAFA_STATEMENT.pdf,NIBSS Instant Payment Outward viaGTWORLD TO JAAFAR I AKUMA REF GW f,NIBSS Instant Payment Outward via GTWORLD TO JAAFARAKUMA REF GW,transfert
17-Mar-2021,'0NIPG,17-Mar-2021,25.00,,"40,003.45",COMMISSION 000013210317154218000044204956NIP TRANSFER COMMISSION FOR000013210317154218000044204956 viaGTWORLD  TO JAAFAR I AKUMAReF:GW681976569000000100002103171540,SAVINGS ACCOUNT,GT_Bank,./static/raw/MR_IBRAHIM_ASHAFA_STATEMENT.pdf,COMMISSION NIP TRANSFER COMMISSION FOR viaGTWORLD TO JAAFAR I AKUMAReF GW,COMMISSION NIP TRANSFER COMMISSION FOR via GTWORLD TO JAAFARAKUMAReF GW,commission
17-Mar-2021,'0NIPG,17-Mar-2021,1.87,,"40,001.58",VALUE ADDED TAX000013210317154218000044204956 VAT ON NIPTRANSFER FOR000013210317154218000044204956 viaGTWORLD  TO JAAFAR I AKUMAReF:GW681976569000000100002103171540,SAVINGS ACCOUNT,GT_Bank,./static/raw/MR_IBRAHIM_ASHAFA_STATEMENT.pdf,VALUE ADDED TAX VAT ON NIPTRANSFER FOR viaGTWORLD TO JAAFAR I AKUMAReF GW,VALUE ADDED TAX VAT ON NIPTRANSFER FOR via GTWORLD TO JAAFARAKUMAReF GW,tax
17-Mar-2021,'0NIPT,17-Mar-2021,,"10,000.00","50,001.58",TRANSFER BETWEEN CUSTOMERS000004210317162313226180077333|MOB/UTO/7420575344/000013/Trans by IbrahimJafar|7420575344||AKUMA  JAAFAR IBRAHIMREF:000004210317162313226180077333,SAVINGS ACCOUNT,GT_Bank,./static/raw/MR_IBRAHIM_ASHAFA_STATEMENT.pdf,TRANSFER BETWEEN CUSTOMERS MOB UTO Trans by IbrahimJafar AKUMA JAAFAR IBRAHIMREF,TRANSFER BETWEEN CUSTOMERS MOB UTO Trans by IbrahimJafar AKUMA JAAFAR IBRAHIMREF,transfert
17-Mar-2021,'0USAT,17-Mar-2021,800.00,,"49,201.58",Airtime Purchase GTWORLD_QL-101CT0000000002446683734-2348038673032,SAVINGS ACCOUNT,GT_Bank,./static/raw/MR_IBRAHIM_ASHAFA_STATEMENT.pdf,Airtime Purchase GTWORLD_QL CT,Airtime Purchase GTWORLDQL CT,utility
17-Mar-2021,'0NIPG,17-Mar-2021,"4,000.00",,"45,201.58",NIBSS Instant Payment Outward000013210317231043000044753681 viaGTWORLD  TO HAPPY EKKI YAKUBU/10.75/REF:GW6819765690000000400021031723  f,SAVINGS ACCOUNT,GT_Bank,./static/raw/MR_IBRAHIM_ASHAFA_STATEMENT.pdf,NIBSS Instant Payment Outward viaGTWORLD TO HAPPY EKKI YAKUBU REF GW f,NIBSS Instant Payment Outward via GTWORLD TO HAPPY EKKI YAKUBU REF GW,transfert
17-Mar-2021,'0NIPG,17-Mar-2021,10.00,,"45,191.58",COMMISSION 000013210317231043000044753681NIP TRANSFER COMMISSION FOR000013210317231043000044753681 viaGTWORLD  TO HAPPY EKKI YAKUBUReF:GW681976569000000040002103172309,SAVINGS ACCOUNT,GT_Bank,./static/raw/MR_IBRAHIM_ASHAFA_STATEMENT.pdf,COMMISSION NIP TRANSFER COMMISSION FOR viaGTWORLD TO HAPPY EKKI YAKUBUReF GW,COMMISSION NIP TRANSFER COMMISSION FOR via GTWORLD TO HAPPY EKKI YAKUBUReF GW,commission
17-Mar-2021,'0NIPG,17-Mar-2021,.75,,"45,190.83",VALUE ADDED TAX000013210317231043000044753681 VAT ON NIPTRANSFER FOR000013210317231043000044753681 viaGTWORLD  TO HAPPY EKKI YAKUBUReF:GW681976569000000040002103172309,SAVINGS ACCOUNT,GT_Bank,./static/raw/MR_IBRAHIM_ASHAFA_STATEMENT.pdf,VALUE ADDED TAX VAT ON NIPTRANSFER FOR viaGTWORLD TO HAPPY EKKI YAKUBUReF GW,VALUE ADDED TAX VAT ON NIPTRANSFER FOR via GTWORLD TO HAPPY EKKI YAKUBUReF GW,tax
17-Mar-2021,'0,17-Mar-2021,50.00,,"45,140.83",STAMP DUTY CHARGE 17032021 STAMP DUTYCHARGE - 17/03/2021,SAVINGS ACCOUNT,GT_Bank,./static/raw/MR_IBRAHIM_ASHAFA_STATEMENT.pdf,STAMP DUTY CHARGE STAMP DUTYCHARGE,STAMP DUTY CHARGE STAMP DUTYCHARGE,bank_charges
18-Mar-2021,'0GWTR,18-Mar-2021.1,"5,000.00",,"40,140.83",TRANSFER BETWEEN CUSTOMERS Via GTWorld REF:681976569000000050002103181221  from ASHAFA IBRAHIM ABDULLAHI  to  AMALA DELIGHT CITY RESTAURANT,SAVINGS ACCOUNT,GT_Bank,./static/raw/MR_IBRAHIM_ASHAFA_STATEMENT.pdf,TRANSFER BETWEEN CUSTOMERS Via GTWorld REF from ASHAFA IBRAHIM ABDULLAHI to AMALA DELIGHT CITY RESTAURANT,TRANSFER BETWEEN CUSTOMERS Via GTWorld REF from ASHAFA IBRAHIM ABDULLAHI to AMALA DELIGHT CITY RESTAURANT,transfert
18-Mar-2021,'0USAT,18-Mar-2021,"1,000.00",,"39,140.83",Airtime Purchase GTWORLD_QL- 101CT0000000002449204849-2348038673032,SAVINGS ACCOUNT,GT_Bank,./static/raw/MR_IBRAHIM_ASHAFA_STATEMENT.pdf,Airtime Purchase GTWORLD_QL CT,Airtime Purchase GTWORLDQL CT,utility
19-Mar-2021,'99995628659999,19-Mar-2021,700.00,,"38,440.83",POS/WEB PURCHASE TRANSACTION  -562865- - 523466-EGWIM DONATUS          LANG           NG,SAVINGS ACCOUNT,GT_Bank,./static/raw/MR_IBRAHIM_ASHAFA_STATEMENT.pdf,POS WEB PURCHASE TRANSACTION EGWIM DONATUS LANG NG,POS WEB PURCHASE TRANSACTION EGWIM DONATUS LANG NG,utility
19-Mar-2021,'0USGT,19-Mar-2021,,"5,000.00","43,440.83","TRANSFER BETWEEN CUSTOMERS Via USSD GTBank Transfer 000000005410536734681097656900000050002021 03191624  from OBALISA, KUNLE OLUWABUKOLA to  ASHAFA IBRAHIM ABDULLAHI",SAVINGS ACCOUNT,GT_Bank,./static/raw/MR_IBRAHIM_ASHAFA_STATEMENT.pdf,TRANSFER BETWEEN CUSTOMERS Via USSD GTBank Transfer from OBALISA KUNLE OLUWABUKOLA to ASHAFA IBRAHIM ABDULLAHI,TRANSFER BETWEEN CUSTOMERS Via USSD GTBank Transfer from OBALISA KUNLE OLUWABUKOLA to ASHAFA IBRAHIM ABDULLAHI,transfert
19-Mar-2021,'99991139589999,19-Mar-2021,"4,300.00",,"39,140.83",POS/WEB PURCHASE TRANSACTION  -113958- - 340671-JEVINIK NIGERIA LIMI   LA           LANG,SAVINGS ACCOUNT,GT_Bank,./static/raw/MR_IBRAHIM_ASHAFA_STATEMENT.pdf,POS WEB PURCHASE TRANSACTION JEVINIK NIGERIA LIMI LA LANG,POS WEB PURCHASE TRANSACTION JEVINIK NIGERIA LIMI LA LANG,utility
20-Mar-2021,'99992127579999,20-Mar-2021,35.00,,"39,105.83",ATM WITHDRAWAL COMMISSION  -212757- - 542533-105716810000001 ZIB 12 Zone  Wuse2 NG,SAVINGS ACCOUNT,GT_Bank,./static/raw/MR_IBRAHIM_ASHAFA_STATEMENT.pdf,ATM WITHDRAWAL COMMISSION ZIB Zone Wuse NG,ATM WITHDRAWAL COMMISSION ZIB Zone Wuse NG,transfert
20-Mar-2021,'99992127579999,20-Mar-2021,"3,000.00",,"36,105.83",CASH WITHDRAWAL FROM OTHER ATM  - 212757- -542533-105716810000001 ZIB 12 Zone Wuse2    NG,SAVINGS ACCOUNT,GT_Bank,./static/raw/MR_IBRAHIM_ASHAFA_STATEMENT.pdf,CASH WITHDRAWAL FROM OTHER ATM ZIB Zone Wuse NG,CASH WITHDRAWAL FROM OTHER ATM ZIB Zone Wuse NG,cash
20-Mar-2021,'0USAT,20-Mar-2021,"1,000.00",,"35,105.83",Airtime Purchase USSD- 101CT0000000002453753804-2348038673032,SAVINGS ACCOUNT,GT_Bank,./static/raw/MR_IBRAHIM_ASHAFA_STATEMENT.pdf,Airtime Purchase USSD CT,Airtime Purchase USSD CT,utility
20-Mar-2021,'0NIPG,20-Mar-2021,"5,000.00",,"30,105.83",NIBSS Instant Payment Outward 000013210320174545000048756162 via GTWORLD  TO HON.ATTAHIRU AUDU OSU /10.75/REF:GW6819765690000000500021032017  f,SAVINGS ACCOUNT,GT_Bank,./static/raw/MR_IBRAHIM_ASHAFA_STATEMENT.pdf,NIBSS Instant Payment Outward via GTWORLD TO HON ATTAHIRU AUDU OSU REF GW f,NIBSS Instant Payment Outward via GTWORLD TO HON ATTAHIRU AUDU OSU REF GW,transfert
20-Mar-2021,'0NIPG,20-Mar-2021,10.00,,"30,095.83",COMMISSION 000013210320174545000048756162 NIP TRANSFER COMMISSION FOR 000013210320174545000048756162 via GTWORLD  TO HON.ATTAHIRU AUDU OSU ReF:GW681976569000000050002103201744,SAVINGS ACCOUNT,GT_Bank,./static/raw/MR_IBRAHIM_ASHAFA_STATEMENT.pdf,COMMISSION NIP TRANSFER COMMISSION FOR via GTWORLD TO HON ATTAHIRU AUDU OSU ReF GW,COMMISSION NIP TRANSFER COMMISSION FOR via GTWORLD TO HON ATTAHIRU AUDU OSU ReF GW,commission
20-Mar-2021,'0NIPG,20-Mar-2021,.75,,"30,095.08",VALUE ADDED TAX 000013210320174545000048756162 VAT ON NIP TRANSFER FOR 000013210320174545000048756162 via GTWORLD  TO HON.ATTAHIRU AUDU OSUReF:GW681976569000000050002103201744,SAVINGS ACCOUNT,GT_Bank,./static/raw/MR_IBRAHIM_ASHAFA_STATEMENT.pdf,VALUE ADDED TAX VAT ON NIP TRANSFER FOR via GTWORLD TO HON ATTAHIRU AUDU OSUReF GW,VALUE ADDED TAX VAT ON NIP TRANSFER FOR via GTWORLD TO HON ATTAHIRU AUDU OSUReF GW,tax
20-Mar-2021,'99996623339999,20-Mar-2021,"15,000.00",,"15,095.08",POS/WEB PURCHASE TRANSACTION  -662333- -509554-A A RANO NIGERIA LIMKNKNNG,SAVINGS ACCOUNT,GT_Bank,./static/raw/MR_IBRAHIM_ASHAFA_STATEMENT.pdf,POS WEB PURCHASE TRANSACTION A A RANO NIGERIA LIMKNKNNG,POS WEB PURCHASE TRANSACTIONA RANO NIGERIA LIMKNKNNG,utility
21-Mar-2021,'0NIPG,21-Mar-2021,"4,000.00",,"11,095.08",NIBSS Instant Payment Outward000013210321062924000049181659 viaGTWORLD  TO OLAH MARIA OGWA/10.75/REF:GW6819765690000000400021032106  f,SAVINGS ACCOUNT,GT_Bank,./static/raw/MR_IBRAHIM_ASHAFA_STATEMENT.pdf,NIBSS Instant Payment Outward viaGTWORLD TO OLAH MARIA OGWA REF GW f,NIBSS Instant Payment Outward via GTWORLD TO OLAH MARIA OGWA REF GW,transfert
21-Mar-2021,'0NIPG,21-Mar-2021,10.00,,"11,085.08",COMMISSION 000013210321062924000049181659NIP TRANSFER COMMISSION FOR000013210321062924000049181659 viaGTWORLD  TO OLAH MARIA OGWAReF:GW681976569000000040002103210627,SAVINGS ACCOUNT,GT_Bank,./static/raw/MR_IBRAHIM_ASHAFA_STATEMENT.pdf,COMMISSION NIP TRANSFER COMMISSION FOR viaGTWORLD TO OLAH MARIA OGWAReF GW,COMMISSION NIP TRANSFER COMMISSION FOR via GTWORLD TO OLAH MARIA OGWAReF GW,commission
21-Mar-2021,'0NIPG,21-Mar-2021,.75,,"11,084.33",VALUE ADDED TAX000013210321062924000049181659 VAT ON NIPTRANSFER FOR000013210321062924000049181659 viaGTWORLD  TO OLAH MARIA OGWAReF:GW681976569000000040002103210627,SAVINGS ACCOUNT,GT_Bank,./static/raw/MR_IBRAHIM_ASHAFA_STATEMENT.pdf,VALUE ADDED TAX VAT ON NIPTRANSFER FOR viaGTWORLD TO OLAH MARIA OGWAReF GW,VALUE ADDED TAX VAT ON NIPTRANSFER FOR via GTWORLD TO OLAH MARIA OGWAReF GW,tax
21-Mar-2021,'0USAT,21-Mar-2021,900.00,,"10,184.33",Airtime Purchase GTWORLD_QL-101CT0000000002455315703-2348038673032,SAVINGS ACCOUNT,GT_Bank,./static/raw/MR_IBRAHIM_ASHAFA_STATEMENT.pdf,Airtime Purchase GTWORLD_QL CT,Airtime Purchase GTWORLDQL CT,utility
21-Mar-2021,'0NIPG,21-Mar-2021,"3,000.00",,"7,184.33",NIBSS Instant Payment Outward000013210321105318000049375729 viaGTWORLD  TO MOHAMMED SALISU ALIYU/10.75/REF:GW6819765690000000300021032110  f,SAVINGS ACCOUNT,GT_Bank,./static/raw/MR_IBRAHIM_ASHAFA_STATEMENT.pdf,NIBSS Instant Payment Outward viaGTWORLD TO MOHAMMED SALISU ALIYU REF GW f,NIBSS Instant Payment Outward via GTWORLD TO MOHAMMED SALISU ALIYU REF GW,transfert
21-Mar-2021,'0NIPG,21-Mar-2021,10.00,,"7,174.33",COMMISSION 000013210321105318000049375729NIP TRANSFER COMMISSION FOR000013210321105318000049375729 viaGTWORLD  TO MOHAMMED SALISU ALIYUReF:GW681976569000000030002103211051,SAVINGS ACCOUNT,GT_Bank,./static/raw/MR_IBRAHIM_ASHAFA_STATEMENT.pdf,COMMISSION NIP TRANSFER COMMISSION FOR viaGTWORLD TO MOHAMMED SALISU ALIYUReF GW,COMMISSION NIP TRANSFER COMMISSION FOR via GTWORLD TO MOHAMMED SALISU ALIYUReF GW,commission
21-Mar-2021,'0NIPG,21-Mar-2021,.75,,"7,173.58",VALUE ADDED TAX000013210321105318000049375729 VAT ON NIPTRANSFER FOR000013210321105318000049375729 viaGTWORLD  TO MOHAMMED SALISU ALIYUReF:GW681976569000000030002103211051,SAVINGS ACCOUNT,GT_Bank,./static/raw/MR_IBRAHIM_ASHAFA_STATEMENT.pdf,VALUE ADDED TAX VAT ON NIPTRANSFER FOR viaGTWORLD TO MOHAMMED SALISU ALIYUReF GW,VALUE ADDED TAX VAT ON NIPTRANSFER FOR via GTWORLD TO MOHAMMED SALISU ALIYUReF GW,tax
21-Mar-2021,'0NIPT,21-Mar-2021,,"8,000.00","15,173.58",TRANSFER BETWEEN CUSTOMERS000015210321151410001590860189||ASHAFAIBRAHIM ABDULLAHI||AISHA NAMAMA ZUBAIRUREF:000015210321151410001590860189,SAVINGS ACCOUNT,GT_Bank,./static/raw/MR_IBRAHIM_ASHAFA_STATEMENT.pdf,TRANSFER BETWEEN CUSTOMERS ASHAFAIBRAHIM ABDULLAHI AISHA NAMAMA ZUBAIRUREF,TRANSFER BETWEEN CUSTOMERS ASHAFAIBRAHIM ABDULLAHI AISHA NAMAMA ZUBAIRUREF,transfert
21-Mar-2021,'99996853949999,21-Mar-2021,"3,250.00",,"11,923.58",POS/WEB PURCHASE TRANSACTION  -685394- -129618-FOOD CONCEPTS PLC-CHLALANG,SAVINGS ACCOUNT,GT_Bank,./static/raw/MR_IBRAHIM_ASHAFA_STATEMENT.pdf,POS WEB PURCHASE TRANSACTION FOOD CONCEPTS PLC CHLALANG,POS WEB PURCHASE TRANSACTION FOOD CONCEPTS PLC CHLALANG,utility
21-Mar-2021,'0USAT,21-Mar-2021,800.00,,"11,123.58",Airtime Purchase GTWORLD_QL-101CT0000000002456780198-2348038673032,SAVINGS ACCOUNT,GT_Bank,./static/raw/MR_IBRAHIM_ASHAFA_STATEMENT.pdf,Airtime Purchase GTWORLD_QL CT,Airtime Purchase GTWORLDQL CT,utility
21-Mar-2021,'1083120000,21-Mar-2021,"6,000.00",,"5,123.58",POS/WEB PURCHASE TRANSACTION  -108312- -386495-SHEMA PETROLEUM LIMIKDKDNG,SAVINGS ACCOUNT,GT_Bank,./static/raw/MR_IBRAHIM_ASHAFA_STATEMENT.pdf,POS WEB PURCHASE TRANSACTION SHEMA PETROLEUM LIMIKDKDNG,POS WEB PURCHASE TRANSACTION SHEMA PETROLEUM LIMIKDKDNG,utility
22-Mar-2021,'0NIPG,22-Mar-2021,"5,000.00",,123.58,NIBSS Instant Payment Outward000013210322134019000050807189 viaGTWORLD  TO JIBRIN BASIRAH USMAN/10.75/REF:GW6819765690000000500021032213  f,SAVINGS ACCOUNT,GT_Bank,./static/raw/MR_IBRAHIM_ASHAFA_STATEMENT.pdf,NIBSS Instant Payment Outward viaGTWORLD TO JIBRIN BASIRAH USMAN REF GW f,NIBSS Instant Payment Outward via GTWORLD TO JIBRIN BASIRAH USMAN REF GW,transfert
22-Mar-2021,'0NIPG,22-Mar-2021,10.00,,113.58,COMMISSION 000013210322134019000050807189NIP TRANSFER COMMISSION FOR000013210322134019000050807189 viaGTWORLD  TO JIBRIN BASIRAH USMANReF:GW681976569000000050002103221338,SAVINGS ACCOUNT,GT_Bank,./static/raw/MR_IBRAHIM_ASHAFA_STATEMENT.pdf,COMMISSION NIP TRANSFER COMMISSION FOR viaGTWORLD TO JIBRIN BASIRAH USMANReF GW,COMMISSION NIP TRANSFER COMMISSION FOR via GTWORLD TO JIBRIN BASIRAH USMANReF GW,commission
22-Mar-2021,'0NIPG,22-Mar-2021,.75,,112.83,VALUE ADDED TAX000013210322134019000050807189 VAT ON NIPTRANSFER FOR000013210322134019000050807189 viaGTWORLD  TO JIBRIN BASIRAH USMANReF:GW681976569000000050002103221338,SAVINGS ACCOUNT,GT_Bank,./static/raw/MR_IBRAHIM_ASHAFA_STATEMENT.pdf,VALUE ADDED TAX VAT ON NIPTRANSFER FOR viaGTWORLD TO JIBRIN BASIRAH USMANReF GW,VALUE ADDED TAX VAT ON NIPTRANSFER FOR via GTWORLD TO JIBRIN BASIRAH USMANReF GW,tax
23-Mar-2021,'0NIPT,23-Mar-2021,,"20,000.00","20,112.83",TRANSFER BETWEEN CUSTOMERS000014210323093959257425743520|NIP000014210323093957004982756983VNS020033210323093957331377136027362556|000014210323093943247065543050||DEMIDE ENEYAMIRE JEMILATU-10REF:000014210323093959257425743520,SAVINGS ACCOUNT,GT_Bank,./static/raw/MR_IBRAHIM_ASHAFA_STATEMENT.pdf,TRANSFER BETWEEN CUSTOMERS NIP VNS DEMIDE ENEYAMIRE JEMILATU REF,TRANSFER BETWEEN CUSTOMERS NIP VNS DEMIDE ENEYAMIRE JEMILATU REF,transfert
23-Mar-2021,'0GAPS,23-Mar-2021,,"95,000.00","115,112.83",TRANSFER BETWEEN CUSTOMERS via GAPScom on Fatima M 4M sales 110042929 0 fromNETCONSTRUCT NIGERIA LIMITED to ASHAFAIBRAHIM ABDULLAHIREF: 0005628626110042929000000,SAVINGS ACCOUNT,GT_Bank,./static/raw/MR_IBRAHIM_ASHAFA_STATEMENT.pdf,TRANSFER BETWEEN CUSTOMERS via GAPScom on Fatima M M sales fromNETCONSTRUCT NIGERIA LIMITED to ASHAFAIBRAHIM ABDULLAHIREF,TRANSFER BETWEEN CUSTOMERS via GAPScom on FatimaM sales from NETCONSTRUCT NIGERIA LIMITED to ASHAFAIBRAHIM ABDULLAHIREF,transfert
23-Mar-2021,'0NIPG,23-Mar-2021,"12,000.00",,"103,112.83",NIBSS Instant Payment Outward000013210323112833000051985792 viaGTWORLD  TO HUSSAINI MUSA/26.875/REF:GW6819765690000001200021032311 f,SAVINGS ACCOUNT,GT_Bank,./static/raw/MR_IBRAHIM_ASHAFA_STATEMENT.pdf,NIBSS Instant Payment Outward viaGTWORLD TO HUSSAINI MUSA REF GW f,NIBSS Instant Payment Outward via GTWORLD TO HUSSAINI MUSA REF GW,transfert
23-Mar-2021,'0NIPG,23-Mar-2021,25.00,,"103,087.83",COMMISSION 000013210323112833000051985792 NIP TRANSFER COMMISSION FOR 000013210323112833000051985792 via GTWORLD  TO HUSSAINI MUSA ReF:GW681976569000000120002103231127,SAVINGS ACCOUNT,GT_Bank,./static/raw/MR_IBRAHIM_ASHAFA_STATEMENT.pdf,COMMISSION NIP TRANSFER COMMISSION FOR via GTWORLD TO HUSSAINI MUSA ReF GW,COMMISSION NIP TRANSFER COMMISSION FOR via GTWORLD TO HUSSAINI MUSA ReF GW,commission
23-Mar-2021,'0NIPG,23-Mar-2021,1.87,,"103,085.96",VALUE ADDED TAX 000013210323112833000051985792 VAT ON NIP TRANSFER FOR 000013210323112833000051985792 via GTWORLD  TO HUSSAINI MUSA ReF:GW681976569000000120002103231127,SAVINGS ACCOUNT,GT_Bank,./static/raw/MR_IBRAHIM_ASHAFA_STATEMENT.pdf,VALUE ADDED TAX VAT ON NIP TRANSFER FOR via GTWORLD TO HUSSAINI MUSA ReF GW,VALUE ADDED TAX VAT ON NIP TRANSFER FOR via GTWORLD TO HUSSAINI MUSA ReF GW,tax
23-Mar-2021,'0NIPG,23-Mar-2021,"14,000.00",,"89,085.96",NIBSS Instant Payment Outward 000013210323113038000051988171 via GTWORLD  TO YAKUBU ASHAFA ABDULLAHI /26.875/REF:GW6819765690000001400021032311 f,SAVINGS ACCOUNT,GT_Bank,./static/raw/MR_IBRAHIM_ASHAFA_STATEMENT.pdf,NIBSS Instant Payment Outward via GTWORLD TO YAKUBU ASHAFA ABDULLAHI REF GW f,NIBSS Instant Payment Outward via GTWORLD TO YAKUBU ASHAFA ABDULLAHI REF GW,transfert
23-Mar-2021,'0NIPG,23-Mar-2021,25.00,,"89,060.96",COMMISSION 000013210323113038000051988171 NIP TRANSFER COMMISSION FOR 000013210323113038000051988171 via GTWORLD  TO YAKUBU ASHAFA ABDULLAHI ReF:GW681976569000000140002103231129,SAVINGS ACCOUNT,GT_Bank,./static/raw/MR_IBRAHIM_ASHAFA_STATEMENT.pdf,COMMISSION NIP TRANSFER COMMISSION FOR via GTWORLD TO YAKUBU ASHAFA ABDULLAHI ReF GW,COMMISSION NIP TRANSFER COMMISSION FOR via GTWORLD TO YAKUBU ASHAFA ABDULLAHI ReF GW,commission
23-Mar-2021,'0NIPG,23-Mar-2021,1.87,,"89,059.09",VALUE ADDED TAX 000013210323113038000051988171 VAT ON NIP TRANSFER FOR 000013210323113038000051988171 via GTWORLD  TO YAKUBU ASHAFA ABDULLAHI ReF:GW681976569000000140002103231129,SAVINGS ACCOUNT,GT_Bank,./static/raw/MR_IBRAHIM_ASHAFA_STATEMENT.pdf,VALUE ADDED TAX VAT ON NIP TRANSFER FOR via GTWORLD TO YAKUBU ASHAFA ABDULLAHI ReF GW,VALUE ADDED TAX VAT ON NIP TRANSFER FOR via GTWORLD TO YAKUBU ASHAFA ABDULLAHI ReF GW,tax
23-Mar-2021,'0NIPG,23-Mar-2021,"4,000.00",,"85,059.09",NIBSS Instant Payment Outward 000013210323113123000051989604 via GTWORLD  TO USMAN YAKUBU BABA /10.75/REF:GW6819765690000000400021032311  f,SAVINGS ACCOUNT,GT_Bank,./static/raw/MR_IBRAHIM_ASHAFA_STATEMENT.pdf,NIBSS Instant Payment Outward via GTWORLD TO USMAN YAKUBU BABA REF GW f,NIBSS Instant Payment Outward via GTWORLD TO USMAN YAKUBU BABA REF GW,transfert
23-Mar-2021,'0NIPG,23-Mar-2021,10.00,,"85,049.09",COMMISSION 000013210323113123000051989604 NIP TRANSFER COMMISSION FOR 000013210323113123000051989604 via GTWORLD  TO USMAN YAKUBU BABA ReF:GW681976569000000040002103231130,SAVINGS ACCOUNT,GT_Bank,./static/raw/MR_IBRAHIM_ASHAFA_STATEMENT.pdf,COMMISSION NIP TRANSFER COMMISSION FOR via GTWORLD TO USMAN YAKUBU BABA ReF GW,COMMISSION NIP TRANSFER COMMISSION FOR via GTWORLD TO USMAN YAKUBU BABA ReF GW,commission
23-Mar-2021,'0NIPG,23-Mar-2021.1,.75,,"85,048.34",VALUE ADDED TAX 000013210323113123000051989604 VAT ON NIP TRANSFER FOR 000013210323113123000051989604 via GTWORLD  TO USMAN YAKUBU BABA ReF:GW681976569000000040002103231130,SAVINGS ACCOUNT,GT_Bank,./static/raw/MR_IBRAHIM_ASHAFA_STATEMENT.pdf,VALUE ADDED TAX VAT ON NIP TRANSFER FOR via GTWORLD TO USMAN YAKUBU BABA ReF GW,VALUE ADDED TAX VAT ON NIP TRANSFER FOR via GTWORLD TO USMAN YAKUBU BABA ReF GW,tax
23-Mar-2021,'0USAT,23-Mar-2021,800.00,,"84,248.34",Airtime Purchase GTWORLD_QL- 101CT0000000002459892396-2348038673032,SAVINGS ACCOUNT,GT_Bank,./static/raw/MR_IBRAHIM_ASHAFA_STATEMENT.pdf,Airtime Purchase GTWORLD_QL CT,Airtime Purchase GTWORLDQL CT,utility
23-Mar-2021,'0NIPG,23-Mar-2021,"3,500.00",,"80,748.34",NIBSS Instant Payment Outward 000013210323170814000052526789 via GTWORLD  TO ADAMS GEORGE UGBEDE /10.75/REF:GW6819765690000000350021032317  f,SAVINGS ACCOUNT,GT_Bank,./static/raw/MR_IBRAHIM_ASHAFA_STATEMENT.pdf,NIBSS Instant Payment Outward via GTWORLD TO ADAMS GEORGE UGBEDE REF GW f,NIBSS Instant Payment Outward via GTWORLD TO ADAMS GEORGE UGBEDE REF GW,transfert
23-Mar-2021,'0NIPG,23-Mar-2021,10.00,,"80,738.34",COMMISSION 000013210323170814000052526789 NIP TRANSFER COMMISSION FOR 000013210323170814000052526789 via GTWORLD  TO ADAMS GEORGE UGBEDE ReF:GW681976569000000035002103231706,SAVINGS ACCOUNT,GT_Bank,./static/raw/MR_IBRAHIM_ASHAFA_STATEMENT.pdf,COMMISSION NIP TRANSFER COMMISSION FOR via GTWORLD TO ADAMS GEORGE UGBEDE ReF GW,COMMISSION NIP TRANSFER COMMISSION FOR via GTWORLD TO ADAMS GEORGE UGBEDE ReF GW,commission
23-Mar-2021,'0NIPG,23-Mar-2021,.75,,"80,737.59",VALUE ADDED TAX 000013210323170814000052526789 VAT ON NIP TRANSFER FOR 000013210323170814000052526789 via GTWORLD  TO ADAMS GEORGE UGBEDE ReF:GW681976569000000035002103231706,SAVINGS ACCOUNT,GT_Bank,./static/raw/MR_IBRAHIM_ASHAFA_STATEMENT.pdf,VALUE ADDED TAX VAT ON NIP TRANSFER FOR via GTWORLD TO ADAMS GEORGE UGBEDE ReF GW,VALUE ADDED TAX VAT ON NIP TRANSFER FOR via GTWORLD TO ADAMS GEORGE UGBEDE ReF GW,tax
23-Mar-2021,'99998709589999,23-Mar-2021,"5,950.00",,"74,787.59",POS/WEB PURCHASE TRANSACTION  -870958- - 936575-KFC                    LA           LANG,SAVINGS ACCOUNT,GT_Bank,./static/raw/MR_IBRAHIM_ASHAFA_STATEMENT.pdf,POS WEB PURCHASE TRANSACTION KFC LA LANG,POS WEB PURCHASE TRANSACTION KFC LA LANG,utility
23-Mar-2021,'0NIPG,23-Mar-2021,"1,500.00",,"73,287.59",NIBSS Instant Payment Outward 000013210323220528000052948335 via GTWORLD  TO AHMED GAMBO MOHAMMED /10.75/REF:GW6819765690000000150021032322  f,SAVINGS ACCOUNT,GT_Bank,./static/raw/MR_IBRAHIM_ASHAFA_STATEMENT.pdf,NIBSS Instant Payment Outward via GTWORLD TO AHMED GAMBO MOHAMMED REF GW f,NIBSS Instant Payment Outward via GTWORLD TO AHMED GAMBO MOHAMMED REF GW,transfert
23-Mar-2021,'0NIPG,23-Mar-2021,10.00,,"73,277.59",COMMISSION 000013210323220528000052948335 NIP TRANSFER COMMISSION FOR 000013210323220528000052948335 via GTWORLD  TO AHMED GAMBO MOHAMMED ReF:GW681976569000000015002103232203,SAVINGS ACCOUNT,GT_Bank,./static/raw/MR_IBRAHIM_ASHAFA_STATEMENT.pdf,COMMISSION NIP TRANSFER COMMISSION FOR via GTWORLD TO AHMED GAMBO MOHAMMED ReF GW,COMMISSION NIP TRANSFER COMMISSION FOR via GTWORLD TO AHMED GAMBO MOHAMMED ReF GW,commission
23-Mar-2021,'0NIPG,23-Mar-2021,.75,,"73,276.84",VALUE ADDED TAX 000013210323220528000052948335 VAT ON NIP TRANSFER FOR 000013210323220528000052948335 viaGTWORLD  TO AHMED GAMBO MOHAMMED ReF:GW681976569000000015002103232203,SAVINGS ACCOUNT,GT_Bank,./static/raw/MR_IBRAHIM_ASHAFA_STATEMENT.pdf,VALUE ADDED TAX VAT ON NIP TRANSFER FOR viaGTWORLD TO AHMED GAMBO MOHAMMED ReF GW,VALUE ADDED TAX VAT ON NIP TRANSFER FOR via GTWORLD TO AHMED GAMBO MOHAMMED ReF GW,tax
23-Mar-2021,'0,23-Mar-2021,100.00,,"73,176.84",STAMP DUTY CHARGE 23032021 STAMP DUTY CHARGE - 23/03/2021,SAVINGS ACCOUNT,GT_Bank,./static/raw/MR_IBRAHIM_ASHAFA_STATEMENT.pdf,STAMP DUTY CHARGE STAMP DUTY CHARGE,STAMP DUTY CHARGE STAMP DUTY CHARGE,bank_charges
24-Mar-2021,'99993733129999,24-Mar-2021,"4,100.00",,"69,076.84",POS/WEB PURCHASE TRANSACTION  -373312- - 292210-AGENCY/TRF-ACC/POS     mararaba NG,SAVINGS ACCOUNT,GT_Bank,./static/raw/MR_IBRAHIM_ASHAFA_STATEMENT.pdf,POS WEB PURCHASE TRANSACTION AGENCY TRF ACC POS mararaba NG,POS WEB PURCHASE TRANSACTION AGENCY TRF ACC POS mararaba NG,utility
24-Mar-2021,'0USAT,24-Mar-2021,400.00,,"68,676.84",Airtime Purchase GTWORLD- 101CT0000000002462724204-2348038510063,SAVINGS ACCOUNT,GT_Bank,./static/raw/MR_IBRAHIM_ASHAFA_STATEMENT.pdf,Airtime Purchase GTWORLD CT,Airtime Purchase GTWORLD CT,utility
24-Mar-2021,'0USAT,24-Mar-2021,500.00,,"68,176.84",Airtime Purchase GTWORLD_QL- 101CT0000000002462929193-2348038673032,SAVINGS ACCOUNT,GT_Bank,./static/raw/MR_IBRAHIM_ASHAFA_STATEMENT.pdf,Airtime Purchase GTWORLD_QL CT,Airtime Purchase GTWORLDQL CT,utility
24-Mar-2021,'0USAT,24-Mar-2021,"1,000.00",,"67,176.84",Airtime Purchase GTWORLD_QL- 101CT0000000002463994110-2348038673032,SAVINGS ACCOUNT,GT_Bank,./static/raw/MR_IBRAHIM_ASHAFA_STATEMENT.pdf,Airtime Purchase GTWORLD_QL CT,Airtime Purchase GTWORLDQL CT,utility
25-Mar-2021,'0NIPG,25-Mar-2021,"7,000.00",,"60,176.84",NIBSS Instant Payment Outward 000013210325141504000055258535 via GTWORLD  TO YAHAYA HARUNA /26.875/REF:GW6819765690000000700021032514 f,SAVINGS ACCOUNT,GT_Bank,./static/raw/MR_IBRAHIM_ASHAFA_STATEMENT.pdf,NIBSS Instant Payment Outward via GTWORLD TO YAHAYA HARUNA REF GW f,NIBSS Instant Payment Outward via GTWORLD TO YAHAYA HARUNA REF GW,transfert
25-Mar-2021,'0NIPG,25-Mar-2021,25.00,,"60,151.84",COMMISSION 000013210325141504000055258535 NIP TRANSFER COMMISSION FOR 000013210325141504000055258535 via GTWORLD  TO YAHAYA HARUNA ReF:GW681976569000000070002103251413,SAVINGS ACCOUNT,GT_Bank,./static/raw/MR_IBRAHIM_ASHAFA_STATEMENT.pdf,COMMISSION NIP TRANSFER COMMISSION FOR via GTWORLD TO YAHAYA HARUNA ReF GW,COMMISSION NIP TRANSFER COMMISSION FOR via GTWORLD TO YAHAYA HARUNA ReF GW,commission
25-Mar-2021,'0NIPG,25-Mar-2021,1.87,,"60,149.97",VALUE ADDED TAX 000013210325141504000055258535 VAT ON NIP TRANSFER FOR 000013210325141504000055258535 via GTWORLD  TO YAHAYA HARUNA ReF:GW681976569000000070002103251413,SAVINGS ACCOUNT,GT_Bank,./static/raw/MR_IBRAHIM_ASHAFA_STATEMENT.pdf,VALUE ADDED TAX VAT ON NIP TRANSFER FOR via GTWORLD TO YAHAYA HARUNA ReF GW,VALUE ADDED TAX VAT ON NIP TRANSFER FOR via GTWORLD TO YAHAYA HARUNA ReF GW,tax
25-Mar-2021,'0USAT,25-Mar-2021,700.00,,"59,449.97",Airtime Purchase GTWORLD_QL- 101CT0000000002466041422-2348038673032,SAVINGS ACCOUNT,GT_Bank,./static/raw/MR_IBRAHIM_ASHAFA_STATEMENT.pdf,Airtime Purchase GTWORLD_QL CT,Airtime Purchase GTWORLDQL CT,utility
25-Mar-2021,'0NIPG,25-Mar-2021,"5,000.00",,"54,449.97",NIBSS Instant Payment Outward 000013210325201335000055886467 via GTWORLD  TO IDA DANLAMI SULE /10.75/REF:GW6819765690000000500021032520  f,SAVINGS ACCOUNT,GT_Bank,./static/raw/MR_IBRAHIM_ASHAFA_STATEMENT.pdf,NIBSS Instant Payment Outward via GTWORLD TO IDA DANLAMI SULE REF GW f,NIBSS Instant Payment Outward via GTWORLD TO IDA DANLAMI SULE REF GW,transfert
25-Mar-2021,'0NIPG,25-Mar-2021,10.00,,"54,439.97",COMMISSION 000013210325201335000055886467 NIP TRANSFER COMMISSION FOR000013210325201335000055886467 via GTWORLD  TO IDA DANLAMI SULE ReF:GW681976569000000050002103252012,SAVINGS ACCOUNT,GT_Bank,./static/raw/MR_IBRAHIM_ASHAFA_STATEMENT.pdf,COMMISSION NIP TRANSFER COMMISSION FOR via GTWORLD TO IDA DANLAMI SULE ReF GW,COMMISSION NIP TRANSFER COMMISSION FOR via GTWORLD TO IDA DANLAMI SULE ReF GW,commission
25-Mar-2021,'0NIPG,25-Mar-2021,.75,,"54,439.22",VALUE ADDED TAX 000013210325201335000055886467 VAT ON NIP TRANSFER FOR 000013210325201335000055886467 via GTWORLD  TO IDA DANLAMI SULE ReF:GW681976569000000050002103252012,SAVINGS ACCOUNT,GT_Bank,./static/raw/MR_IBRAHIM_ASHAFA_STATEMENT.pdf,VALUE ADDED TAX VAT ON NIP TRANSFER FOR via GTWORLD TO IDA DANLAMI SULE ReF GW,VALUE ADDED TAX VAT ON NIP TRANSFER FOR via GTWORLD TO IDA DANLAMI SULE ReF GW,tax
25-Mar-2021,'7681210000,25-Mar-2021,"4,000.00",,"50,439.22",POS/WEB PURCHASE TRANSACTION  -768121- - 543594-SHEMA PETROLEUM LIMI   KD KDNG,SAVINGS ACCOUNT,GT_Bank,./static/raw/MR_IBRAHIM_ASHAFA_STATEMENT.pdf,POS WEB PURCHASE TRANSACTION SHEMA PETROLEUM LIMI KD KDNG,POS WEB PURCHASE TRANSACTION SHEMA PETROLEUM LIMI KD KDNG,utility
26-Mar-2021,'99997845239999,26-Mar-2021,"20,500.00",,"29,939.22",POS/WEB PURCHASE TRANSACTION  -784523- - 338898-AGENCY/TRF-ACC/POS     JABI-ABUJA NG,SAVINGS ACCOUNT,GT_Bank,./static/raw/MR_IBRAHIM_ASHAFA_STATEMENT.pdf,POS WEB PURCHASE TRANSACTION AGENCY TRF ACC POS JABI ABUJA NG,POS WEB PURCHASE TRANSACTION AGENCY TRF ACC POS JABI ABUJA NG,cash
26-Mar-2021,'0GWTR,26-Mar-2021,"10,000.00",,"19,939.22","TRANSFER BETWEEN CUSTOMERS Via GTWorld REF:681976569000000100002103261250  from ASHAFA IBRAHIM ABDULLAHI  to  ABDULLAHI, AISHA MAMMAN",SAVINGS ACCOUNT,GT_Bank,./static/raw/MR_IBRAHIM_ASHAFA_STATEMENT.pdf,TRANSFER BETWEEN CUSTOMERS Via GTWorld REF from ASHAFA IBRAHIM ABDULLAHI to ABDULLAHI AISHA MAMMAN,TRANSFER BETWEEN CUSTOMERS Via GTWorld REF from ASHAFA IBRAHIM ABDULLAHI to ABDULLAHI AISHA MAMMAN,transfert
26-Mar-2021,'99990029699999,26-Mar-2021,35.00,,"19,904.22",ATM WITHDRAWAL COMMISSION  -002969- - 729573-JAIZ BK MARARABA       NASARAWA ST NSNG,SAVINGS ACCOUNT,GT_Bank,./static/raw/MR_IBRAHIM_ASHAFA_STATEMENT.pdf,ATM WITHDRAWAL COMMISSION JAIZ BK MARARABA NASARAWA ST NSNG,ATM WITHDRAWAL COMMISSION JAIZ BK MARARABA NASARAWA ST NSNG,utility
26-Mar-2021,'99990029699999,26-Mar-2021,"5,000.00",,"14,904.22",CASH WITHDRAWAL FROM OTHER ATM  - 002969- -729573-JAIZ BK MARARABA NASARAWA ST  NSNG,SAVINGS ACCOUNT,GT_Bank,./static/raw/MR_IBRAHIM_ASHAFA_STATEMENT.pdf,CASH WITHDRAWAL FROM OTHER ATM JAIZ BK MARARABA NASARAWA ST NSNG,CASH WITHDRAWAL FROM OTHER ATM JAIZ BK MARARABA NASARAWA ST NSNG,cash
26-Mar-2021,'0USAT,26-Mar-2021,800.00,,"14,104.22",Airtime Purchase GTWORLD_QL- 101CT0000000002469092041-2348038673032,SAVINGS ACCOUNT,GT_Bank,./static/raw/MR_IBRAHIM_ASHAFA_STATEMENT.pdf,Airtime Purchase GTWORLD_QL CT,Airtime Purchase GTWORLDQL CT,utility
27-Mar-2021,'99999456889999,27-Mar-2021,"4,000.00",,"10,104.22",POS/WEB PURCHASE TRANSACTION  -945688- - 592606-HUSSEIN IBRAHIM  KAS   FCNG           NG,SAVINGS ACCOUNT,GT_Bank,./static/raw/MR_IBRAHIM_ASHAFA_STATEMENT.pdf,POS WEB PURCHASE TRANSACTION HUSSEIN IBRAHIM KAS FCNG NG,POS WEB PURCHASE TRANSACTION HUSSEIN IBRAHIM KAS FCNG NG,others
27-Mar-2021,'0NIPG,27-Mar-2021,"5,000.00",,"5,104.22",NIBSS Instant Payment Outward 000013210327191244000058946966 via GTWORLD  TO YUSUF HASSAN /10.75/REF:GW6819765690000000500021032719  f,SAVINGS ACCOUNT,GT_Bank,./static/raw/MR_IBRAHIM_ASHAFA_STATEMENT.pdf,NIBSS Instant Payment Outward via GTWORLD TO YUSUF HASSAN REF GW f,NIBSS Instant Payment Outward via GTWORLD TO YUSUF HASSAN REF GW,transfert
27-Mar-2021,'0NIPG,27-Mar-2021,10.00,,"5,094.22",COMMISSION 000013210327191244000058946966 NIP TRANSFER COMMISSION FOR 000013210327191244000058946966 via GTWORLD  TO YUSUF HASSANReF:GW681976569000000050002103271911,SAVINGS ACCOUNT,GT_Bank,./static/raw/MR_IBRAHIM_ASHAFA_STATEMENT.pdf,COMMISSION NIP TRANSFER COMMISSION FOR via GTWORLD TO YUSUF HASSANReF GW,COMMISSION NIP TRANSFER COMMISSION FOR via GTWORLD TO YUSUF HASSANReF GW,commission
27-Mar-2021,'0NIPG,27-Mar-2021,.75,,"5,093.47",VALUE ADDED TAX 000013210327191244000058946966 VAT ON NIP TRANSFER FOR 000013210327191244000058946966 via GTWORLD  TO YUSUF HASSAN ReF:GW681976569000000050002103271911,SAVINGS ACCOUNT,GT_Bank,./static/raw/MR_IBRAHIM_ASHAFA_STATEMENT.pdf,VALUE ADDED TAX VAT ON NIP TRANSFER FOR via GTWORLD TO YUSUF HASSAN ReF GW,VALUE ADDED TAX VAT ON NIP TRANSFER FOR via GTWORLD TO YUSUF HASSAN ReF GW,tax
28-Mar-2021,'0USAT,28-Mar-2021,"1,000.00",,"4,093.47",Airtime Purchase GTWORLD_QL- 101CT0000000002473606196-2348038673032,SAVINGS ACCOUNT,GT_Bank,./static/raw/MR_IBRAHIM_ASHAFA_STATEMENT.pdf,Airtime Purchase GTWORLD_QL CT,Airtime Purchase GTWORLDQL CT,utility
28-Mar-2021,'0NIPG,28-Mar-2021,"2,000.00",,"2,093.47",NIBSS Instant Payment Outward 000013210328211343000060213648 via GTWORLD  TO OGAR PRISCA E /10.75/REF:GW6819765690000000200021032821  f,SAVINGS ACCOUNT,GT_Bank,./static/raw/MR_IBRAHIM_ASHAFA_STATEMENT.pdf,NIBSS Instant Payment Outward via GTWORLD TO OGAR PRISCA E REF GW f,NIBSS Instant Payment Outward via GTWORLD TO OGAR PRISCAREF GW,transfert
28-Mar-2021,'0NIPG,28-Mar-2021,10.00,,"2,083.47",COMMISSION 000013210328211343000060213648 NIP TRANSFER COMMISSION FOR 000013210328211343000060213648 via GTWORLD  TO OGAR PRISCA E ReF:GW681976569000000020002103282112,SAVINGS ACCOUNT,GT_Bank,./static/raw/MR_IBRAHIM_ASHAFA_STATEMENT.pdf,COMMISSION NIP TRANSFER COMMISSION FOR via GTWORLD TO OGAR PRISCA E ReF GW,COMMISSION NIP TRANSFER COMMISSION FOR via GTWORLD TO OGAR PRISCAReF GW,commission
28-Mar-2021,'0NIPG,28-Mar-2021,.75,,"2,082.72",VALUE ADDED TAX 000013210328211343000060213648 VAT ON NIP TRANSFER FOR 000013210328211343000060213648 via GTWORLD  TO OGAR PRISCA E ReF:GW681976569000000020002103282112,SAVINGS ACCOUNT,GT_Bank,./static/raw/MR_IBRAHIM_ASHAFA_STATEMENT.pdf,VALUE ADDED TAX VAT ON NIP TRANSFER FOR via GTWORLD TO OGAR PRISCA E ReF GW,VALUE ADDED TAX VAT ON NIP TRANSFER FOR via GTWORLD TO OGAR PRISCAReF GW,tax
28-Mar-2021,'0NIPG,28-Mar-2021,"1,500.00",,582.72,NIBSS Instant Payment Outward 000013210328221828000060273286 via GTWORLD  TO Maryam   Haruna /10.75/REF:GW6819765690000000150021032822  f,SAVINGS ACCOUNT,GT_Bank,./static/raw/MR_IBRAHIM_ASHAFA_STATEMENT.pdf,NIBSS Instant Payment Outward via GTWORLD TO Maryam Haruna REF GW f,NIBSS Instant Payment Outward via GTWORLD TO Maryam Haruna REF GW,transfert
28-Mar-2021,'0NIPG,28-Mar-2021,10.00,,572.72,COMMISSION 000013210328221828000060273286 NIP TRANSFER COMMISSION FOR 000013210328221828000060273286 via GTWORLD  TO Maryam   Haruna ReF:GW681976569000000015002103282216,SAVINGS ACCOUNT,GT_Bank,./static/raw/MR_IBRAHIM_ASHAFA_STATEMENT.pdf,COMMISSION NIP TRANSFER COMMISSION FOR via GTWORLD TO Maryam Haruna ReF GW,COMMISSION NIP TRANSFER COMMISSION FOR via GTWORLD TO Maryam Haruna ReF GW,commission
28-Mar-2021,'0NIPG,28-Mar-2021,.75,,571.97,VALUE ADDED TAX 000013210328221828000060273286 VAT ON NIP TRANSFER FOR 000013210328221828000060273286 via GTWORLD  TO Maryam   HarunaReF:GW681976569000000015002103282216,SAVINGS ACCOUNT,GT_Bank,./static/raw/MR_IBRAHIM_ASHAFA_STATEMENT.pdf,VALUE ADDED TAX VAT ON NIP TRANSFER FOR via GTWORLD TO Maryam HarunaReF GW,VALUE ADDED TAX VAT ON NIP TRANSFER FOR via GTWORLD TO Maryam HarunaReF GW,tax
29-Mar-2021,'0NIPT,29-Mar-2021,,"43,263.08","43,835.05",TRANSFER BETWEEN CUSTOMERS 000016210329145708000026114936|CIB:REFUND OFDOUBLEPAYMENT|637526266288117546||LIBE RTA LEASING LIMITED REF:000016210329145708000026114936,SAVINGS ACCOUNT,GT_Bank,./static/raw/MR_IBRAHIM_ASHAFA_STATEMENT.pdf,TRANSFER BETWEEN CUSTOMERS CIB REFUND OFDOUBLEPAYMENT LIBE RTA LEASING LIMITED REF,TRANSFER BETWEEN CUSTOMERS CIB REFUND OFDOUBLEPAYMENT LIBE RTA LEASING LIMITED REF,transfert
29-Mar-2021,'0NIPG,29-Mar-2021,"40,000.00",,"3,835.05",NIBSS Instant Payment Outward 000013210329150418000061206404 via GTWORLD  TO ASHAFA IBRAHIM /26.875/REF:GW6819765690000004000021032915 f,SAVINGS ACCOUNT,GT_Bank,./static/raw/MR_IBRAHIM_ASHAFA_STATEMENT.pdf,NIBSS Instant Payment Outward via GTWORLD TO ASHAFA IBRAHIM REF GW f,NIBSS Instant Payment Outward via GTWORLD TO ASHAFA IBRAHIM REF GW,transfert
29-Mar-2021,'0NIPG,29-Mar-2021,25.00,,"3,810.05",COMMISSION 000013210329150418000061206404 NIP TRANSFER COMMISSION FOR 000013210329150418000061206404 via GTWORLD  TO ASHAFA IBRAHIM ReF:GW681976569000000400002103291502,SAVINGS ACCOUNT,GT_Bank,./static/raw/MR_IBRAHIM_ASHAFA_STATEMENT.pdf,COMMISSION NIP TRANSFER COMMISSION FOR via GTWORLD TO ASHAFA IBRAHIM ReF GW,COMMISSION NIP TRANSFER COMMISSION FOR via GTWORLD TO ASHAFA IBRAHIM ReF GW,commission
29-Mar-2021,'0NIPG,29-Mar-2021,1.87,,"3,808.18",VALUE ADDED TAX 000013210329150418000061206404 VAT ON NIP TRANSFER FOR 000013210329150418000061206404 via GTWORLD  TO ASHAFA IBRAHIM ReF:GW681976569000000400002103291502,SAVINGS ACCOUNT,GT_Bank,./static/raw/MR_IBRAHIM_ASHAFA_STATEMENT.pdf,VALUE ADDED TAX VAT ON NIP TRANSFER FOR via GTWORLD TO ASHAFA IBRAHIM ReF GW,VALUE ADDED TAX VAT ON NIP TRANSFER FOR via GTWORLD TO ASHAFA IBRAHIM ReF GW,tax
29-Mar-2021,'0USAT,29-Mar-2021,600.00,,"3,208.18",Airtime Purchase GTWORLD- 101CT0000000002475418388-2348038673032,SAVINGS ACCOUNT,GT_Bank,./static/raw/MR_IBRAHIM_ASHAFA_STATEMENT.pdf,Airtime Purchase GTWORLD CT,Airtime Purchase GTWORLD CT,utility
29-Mar-2021,'1277570000,29-Mar-2021,"2,600.00",,608.18,POS/WEB PURCHASE TRANSACTION  -127757- - 543330-TONIA PHARMACY LIMIT   LA           LANG,SAVINGS ACCOUNT,GT_Bank,./static/raw/MR_IBRAHIM_ASHAFA_STATEMENT.pdf,POS WEB PURCHASE TRANSACTION TONIA PHARMACY LIMIT LA LANG,POS WEB PURCHASE TRANSACTION TONIA PHARMACY LIMIT LA LANG,utility
29-Mar-2021,'1277570000,29-Mar-2021,,"2,600.00","3,208.18",POS/WEB TRANSACTION REVERSAL  -127757- - 543330-TONIA PHARMACY LIMIT   LA           LANG,SAVINGS ACCOUNT,GT_Bank,./static/raw/MR_IBRAHIM_ASHAFA_STATEMENT.pdf,POS WEB TRANSACTION REVERSAL TONIA PHARMACY LIMIT LA LANG,POS WEB TRANSACTION REVERSAL TONIA PHARMACY LIMIT LA LANG,utility
29-Mar-2021,'99991397499999,29-Mar-2021,"2,600.00",,608.18,POS/WEB PURCHASE TRANSACTION  -139749- - 551193-Tonia pharmacy         LA           FCNG,SAVINGS ACCOUNT,GT_Bank,./static/raw/MR_IBRAHIM_ASHAFA_STATEMENT.pdf,POS WEB PURCHASE TRANSACTION Tonia pharmacy LA FCNG,POS WEB PURCHASE TRANSACTION Tonia pharmacy LA FCNG,utility
30-Mar-2021,'0,29-Mar-2021,50.00,,558.18,STAMP DUTY CHARGE 29032021 STAMP DUTY CHARGE - 29/03/2021,SAVINGS ACCOUNT,GT_Bank,./static/raw/MR_IBRAHIM_ASHAFA_STATEMENT.pdf,STAMP DUTY CHARGE STAMP DUTY CHARGE,STAMP DUTY CHARGE STAMP DUTY CHARGE,bank_charges
30-Mar-2021,'0USAT,30-Mar-2021,500.00,,58.18,Airtime Purchase GTWORLD_QL- 101CT0000000002479006315-2348038673032,SAVINGS ACCOUNT,GT_Bank,./static/raw/MR_IBRAHIM_ASHAFA_STATEMENT.pdf,Airtime Purchase GTWORLD_QL CT,Airtime Purchase GTWORLDQL CT,utility
31-Mar-2021,'41200012075,31-Mar-2021,"26,529.45",,"-26,471.27",MATURED LOAN INSTALLMENT,SAVINGS ACCOUNT,GT_Bank,./static/raw/MR_IBRAHIM_ASHAFA_STATEMENT.pdf,MATURED LOAN INSTALLMENT,MATURED LOAN INSTALLMENT,loan
31-Mar-2021,'0,31-Mar-2021,20.31,,"-26,491.58",INTEREST CAPITALISED,SAVINGS ACCOUNT,GT_Bank,./static/raw/MR_IBRAHIM_ASHAFA_STATEMENT.pdf,INTEREST CAPITALISED,INTEREST CAPITALISED,loan
01-Apr-2021,'0NIPT,01-Apr-2021.1,,"110,004.95","83,513.37",TRANSFER BETWEEN CUSTOMERS 000004210401110443200095077282|TUD IBG/UTO/NetC Mar Sal Ashsfa|200095077282||NET CONSTRUCT NIGERIA LIMITED REF:000004210401110443200095077282,SAVINGS ACCOUNT,GT_Bank,./static/raw/MR_IBRAHIM_ASHAFA_STATEMENT.pdf,TRANSFER BETWEEN CUSTOMERS TUD IBG UTO NetC Mar Sal Ashsfa NET CONSTRUCT NIGERIA LIMITED REF,TRANSFER BETWEEN CUSTOMERS TUD IBG UTO NetC Mar Sal Ashsfa NET CONSTRUCT NIGERIA LIMITED REF,transfert
02-Apr-2021,'0,01-Apr-2021,50.00,,"83,463.37",STAMP DUTY CHARGE 01042021 STAMP DUTY CHARGE - 01/04/2021,SAVINGS ACCOUNT,GT_Bank,./static/raw/MR_IBRAHIM_ASHAFA_STATEMENT.pdf,STAMP DUTY CHARGE STAMP DUTY CHARGE,STAMP DUTY CHARGE STAMP DUTY CHARGE,bank_charges
02-Apr-2021,'230,01-Apr-2021,816.00,,"82,647.37",SMS ALERT CHARGE FOR 19FEB2021- 25MAR2021,SAVINGS ACCOUNT,GT_Bank,./static/raw/MR_IBRAHIM_ASHAFA_STATEMENT.pdf,SMS ALERT CHARGE FOR FEB MAR,SMS ALERT CHARGE FOR FEB MAR,loan
02-Apr-2021,'0NIPT,02-Apr-2021,,"5,000.00","87,647.37",TRANSFER BETWEEN CUSTOMERS 000015210402073247001624891512|C|397238767|| MOHAMMED KABIRU  Y. REF:000015210402073247001624891512,SAVINGS ACCOUNT,GT_Bank,./static/raw/MR_IBRAHIM_ASHAFA_STATEMENT.pdf,TRANSFER BETWEEN CUSTOMERS C MOHAMMED KABIRU Y REF,TRANSFER BETWEEN CUSTOMERSMOHAMMED KABIRUREF,transfert
02-Apr-2021,'0NIPG,02-Apr-2021,"50,000.00",,"37,647.37",NIBSS Instant Payment Outward 000013210402074210000067538758 via GTWORLD  TO IBRAHIM ASHAFA /26.875/REF:GW6819765690000005000021040207 f,SAVINGS ACCOUNT,GT_Bank,./static/raw/MR_IBRAHIM_ASHAFA_STATEMENT.pdf,NIBSS Instant Payment Outward via GTWORLD TO IBRAHIM ASHAFA REF GW f,NIBSS Instant Payment Outward via GTWORLD TO IBRAHIM ASHAFA REF GW,transfert
02-Apr-2021,'0NIPG,02-Apr-2021,25.00,,"37,622.37",COMMISSION 000013210402074210000067538758 NIP TRANSFER COMMISSION FOR 000013210402074210000067538758 via GTWORLD  TO IBRAHIM ASHAFA ReF:GW681976569000000500002104020740,SAVINGS ACCOUNT,GT_Bank,./static/raw/MR_IBRAHIM_ASHAFA_STATEMENT.pdf,COMMISSION NIP TRANSFER COMMISSION FOR via GTWORLD TO IBRAHIM ASHAFA ReF GW,COMMISSION NIP TRANSFER COMMISSION FOR via GTWORLD TO IBRAHIM ASHAFA ReF GW,commission
02-Apr-2021,'0NIPG,02-Apr-2021,1.87,,"37,620.50",VALUE ADDED TAX 000013210402074210000067538758 VAT ON NIP TRANSFER FOR 000013210402074210000067538758 via GTWORLD  TO IBRAHIM ASHAFA ReF:GW681976569000000500002104020740,SAVINGS ACCOUNT,GT_Bank,./static/raw/MR_IBRAHIM_ASHAFA_STATEMENT.pdf,VALUE ADDED TAX VAT ON NIP TRANSFER FOR via GTWORLD TO IBRAHIM ASHAFA ReF GW,VALUE ADDED TAX VAT ON NIP TRANSFER FOR via GTWORLD TO IBRAHIM ASHAFA ReF GW,tax
02-Apr-2021,'0NIPG,02-Apr-2021,"2,000.00",,"35,620.50",NIBSS Instant Payment Outward 000013210402154517000068452216 via GTWORLD  TO ADO ABDUL BWARI /10.75/REF:GW6819765690000000200021040215  f,SAVINGS ACCOUNT,GT_Bank,./static/raw/MR_IBRAHIM_ASHAFA_STATEMENT.pdf,NIBSS Instant Payment Outward via GTWORLD TO ADO ABDUL BWARI REF GW f,NIBSS Instant Payment Outward via GTWORLD TO ADO ABDUL BWARI REF GW,transfert
02-Apr-2021,'0NIPG,02-Apr-2021,10.00,,"35,610.50",COMMISSION 000013210402154517000068452216 NIP TRANSFER COMMISSION FOR 000013210402154517000068452216 via GTWORLD  TO ADO ABDUL BWARI ReF:GW681976569000000020002104021543,SAVINGS ACCOUNT,GT_Bank,./static/raw/MR_IBRAHIM_ASHAFA_STATEMENT.pdf,COMMISSION NIP TRANSFER COMMISSION FOR via GTWORLD TO ADO ABDUL BWARI ReF GW,COMMISSION NIP TRANSFER COMMISSION FOR via GTWORLD TO ADO ABDUL BWARI ReF GW,commission
02-Apr-2021,'0NIPG,02-Apr-2021.1,.75,,"35,609.75",VALUE ADDED TAX 000013210402154517000068452216 VAT ON NIP TRANSFER FOR 000013210402154517000068452216 via GTWORLD  TO ADO ABDUL BWARI ReF:GW681976569000000020002104021543,SAVINGS ACCOUNT,GT_Bank,./static/raw/MR_IBRAHIM_ASHAFA_STATEMENT.pdf,VALUE ADDED TAX VAT ON NIP TRANSFER FOR via GTWORLD TO ADO ABDUL BWARI ReF GW,VALUE ADDED TAX VAT ON NIP TRANSFER FOR via GTWORLD TO ADO ABDUL BWARI ReF GW,tax
03-Apr-2021,'0NIPG,03-Apr-2021,"3,500.00",,"32,109.75",NIBSS Instant Payment Outward 000013210403094458000069528427 via GTWORLD Bills TO MARYAM USMAN ABUBAKAR /10.75/REF:GW6819765690000000350021040309  f,SAVINGS ACCOUNT,GT_Bank,./static/raw/MR_IBRAHIM_ASHAFA_STATEMENT.pdf,NIBSS Instant Payment Outward via GTWORLD Bills TO MARYAM USMAN ABUBAKAR REF GW f,NIBSS Instant Payment Outward via GTWORLD Bills TO MARYAM USMAN ABUBAKAR REF GW,transfert
03-Apr-2021,'0NIPG,03-Apr-2021,10.00,,"32,099.75",COMMISSION 000013210403094458000069528427 NIP TRANSFER COMMISSION FOR 000013210403094458000069528427 via GTWORLD Bills TO MARYAM USMAN ABUBAKAR ReF:GW681976569000000035002104030943,SAVINGS ACCOUNT,GT_Bank,./static/raw/MR_IBRAHIM_ASHAFA_STATEMENT.pdf,COMMISSION NIP TRANSFER COMMISSION FOR via GTWORLD Bills TO MARYAM USMAN ABUBAKAR ReF GW,COMMISSION NIP TRANSFER COMMISSION FOR via GTWORLD Bills TO MARYAM USMAN ABUBAKAR ReF GW,commission
03-Apr-2021,'0NIPG,03-Apr-2021,.75,,"32,099.00",VALUE ADDED TAX 000013210403094458000069528427 VAT ON NIP TRANSFER FOR 000013210403094458000069528427 via GTWORLD Bills TO MARYAM USMAN ABUBAKAR ReF:GW681976569000000035002104030943,SAVINGS ACCOUNT,GT_Bank,./static/raw/MR_IBRAHIM_ASHAFA_STATEMENT.pdf,VALUE ADDED TAX VAT ON NIP TRANSFER FOR via GTWORLD Bills TO MARYAM USMAN ABUBAKAR ReF GW,VALUE ADDED TAX VAT ON NIP TRANSFER FOR via GTWORLD Bills TO MARYAM USMAN ABUBAKAR ReF GW,tax
03-Apr-2021,'99995267149999,03-Apr-2021,"5,000.00",,"27,099.00",CASH WITHDRAWAL FROM OTHER ATM  - 526714- -988083-SWTFBPsnk              asokoro NG,SAVINGS ACCOUNT,GT_Bank,./static/raw/MR_IBRAHIM_ASHAFA_STATEMENT.pdf,CASH WITHDRAWAL FROM OTHER ATM SWTFBPsnk asokoro NG,CASH WITHDRAWAL FROM OTHER ATM SWTFBPsnk asokoro NG,cash
04-Apr-2021,'0NIPG,04-Apr-2021,"5,000.00",,"22,099.00",NIBSS Instant Payment Outward 000013210404070259000070909050 via GTWORLD Bill TO YUSUF HASSAN /10.75/REF:GW6819765690000000500021040407  f,SAVINGS ACCOUNT,GT_Bank,./static/raw/MR_IBRAHIM_ASHAFA_STATEMENT.pdf,NIBSS Instant Payment Outward via GTWORLD Bill TO YUSUF HASSAN REF GW f,NIBSS Instant Payment Outward via GTWORLD Bill TO YUSUF HASSAN REF GW,transfert
04-Apr-2021,'0NIPG,04-Apr-2021,10.00,,"22,089.00",COMMISSION 000013210404070259000070909050 NIP TRANSFER COMMISSION FOR 000013210404070259000070909050 via GTWORLD Bill TO YUSUF HASSAN ReF:GW681976569000000050002104040701,SAVINGS ACCOUNT,GT_Bank,./static/raw/MR_IBRAHIM_ASHAFA_STATEMENT.pdf,COMMISSION NIP TRANSFER COMMISSION FOR via GTWORLD Bill TO YUSUF HASSAN ReF GW,COMMISSION NIP TRANSFER COMMISSION FOR via GTWORLD Bill TO YUSUF HASSAN ReF GW,commission
04-Apr-2021,'0NIPG,04-Apr-2021,.75,,"22,088.25",VALUE ADDED TAX 000013210404070259000070909050 VAT ON NIP TRANSFER FOR 000013210404070259000070909050 via GTWORLD Bill TO YUSUF HASSAN ReF:GW681976569000000050002104040701,SAVINGS ACCOUNT,GT_Bank,./static/raw/MR_IBRAHIM_ASHAFA_STATEMENT.pdf,VALUE ADDED TAX VAT ON NIP TRANSFER FOR via GTWORLD Bill TO YUSUF HASSAN ReF GW,VALUE ADDED TAX VAT ON NIP TRANSFER FOR via GTWORLD Bill TO YUSUF HASSAN ReF GW,tax
04-Apr-2021,'0USAT,04-Apr-2021.1,"1,000.00",,"21,088.25",Airtime Purchase GTWORLD_QL- 101CT0000000002490626388-2347063168196,SAVINGS ACCOUNT,GT_Bank,./static/raw/MR_IBRAHIM_ASHAFA_STATEMENT.pdf,Airtime Purchase GTWORLD_QL CT,Airtime Purchase GTWORLDQL CT,utility
04-Apr-2021,'0USAT,04-Apr-2021,900.00,,"20,188.25",Airtime Purchase GTWORLD_QL- 101CT0000000002491102515-2348038673032,SAVINGS ACCOUNT,GT_Bank,./static/raw/MR_IBRAHIM_ASHAFA_STATEMENT.pdf,Airtime Purchase GTWORLD_QL CT,Airtime Purchase GTWORLDQL CT,utility
05-Apr-2021,'0USAT,05-Apr-2021,"1,000.00",,"19,188.25",Airtime Purchase GTWORLD_QL- 101CT0000000002491343197-2348101212569,SAVINGS ACCOUNT,GT_Bank,./static/raw/MR_IBRAHIM_ASHAFA_STATEMENT.pdf,Airtime Purchase GTWORLD_QL CT,Airtime Purchase GTWORLDQL CT,utility
05-Apr-2021,'99991768899999,05-Apr-2021,"4,000.00",,"15,188.25",CASH WITHDRAWAL FROM OTHER ATM  - 176889- -381256-000000000000738 New Wu Abuja NG,SAVINGS ACCOUNT,GT_Bank,./static/raw/MR_IBRAHIM_ASHAFA_STATEMENT.pdf,CASH WITHDRAWAL FROM OTHER ATM New Wu Abuja NG,CASH WITHDRAWAL FROM OTHER ATM New Wu Abuja NG,cash
05-Apr-2021,'0USAT,05-Apr-2021,"1,000.00",,"14,188.25",Airtime Purchase GTWORLD_QL- 101CT0000000002493389012-2348038673032,SAVINGS ACCOUNT,GT_Bank,./static/raw/MR_IBRAHIM_ASHAFA_STATEMENT.pdf,Airtime Purchase GTWORLD_QL CT,Airtime Purchase GTWORLDQL CT,utility
05-Apr-2021,'8651070000,05-Apr-2021,"10,000.00",,"4,188.25",POS/WEB PURCHASE TRANSACTION  -865107- - 208499-SHEMA PETROLEUM LIMI   KD KDNG,SAVINGS ACCOUNT,GT_Bank,./static/raw/MR_IBRAHIM_ASHAFA_STATEMENT.pdf,POS WEB PURCHASE TRANSACTION SHEMA PETROLEUM LIMI KD KDNG,POS WEB PURCHASE TRANSACTION SHEMA PETROLEUM LIMI KD KDNG,utility
06-Apr-2021,'0USAT,06-Apr-2021,300.00,,"3,888.25",Airtime Purchase GTWORLD_QL- 101CT0000000002495754185-2348146523935,SAVINGS ACCOUNT,GT_Bank,./static/raw/MR_IBRAHIM_ASHAFA_STATEMENT.pdf,Airtime Purchase GTWORLD_QL CT,Airtime Purchase GTWORLDQL CT,utility
06-Apr-2021,'0USAT,06-Apr-2021,700.00,,"3,188.25",Airtime Purchase GTWORLD_QL- 101CT0000000002495755650-2348038673032,SAVINGS ACCOUNT,GT_Bank,./static/raw/MR_IBRAHIM_ASHAFA_STATEMENT.pdf,Airtime Purchase GTWORLD_QL CT,Airtime Purchase GTWORLDQL CT,utility
07-Apr-2021,'0USAT,07-Apr-2021,"1,000.00",,"2,188.25",Airtime Purchase GTWORLD_QL- 101CT0000000002496385041-2348038673032,SAVINGS ACCOUNT,GT_Bank,./static/raw/MR_IBRAHIM_ASHAFA_STATEMENT.pdf,Airtime Purchase GTWORLD_QL CT,Airtime Purchase GTWORLDQL CT,utility
07-Apr-2021,'0NIPT,07-Apr-2021,,"2,000.00","4,188.25",TRANSFER BETWEEN CUSTOMERS 000010210407061748111115022229|REF70084493 4 BO abdullahi ibrahim IFO ASHAFA IBRA|700844934||abdullahi ibrahim REF:000010210407061748111115022229,SAVINGS ACCOUNT,GT_Bank,./static/raw/MR_IBRAHIM_ASHAFA_STATEMENT.pdf,TRANSFER BETWEEN CUSTOMERS REF BO abdullahi ibrahim IFO ASHAFA IBRA abdullahi ibrahim REF,TRANSFER BETWEEN CUSTOMERS REF BO abdullahi ibrahim IFO ASHAFA IBRA abdullahi ibrahim REF,transfert
07-Apr-2021,'0USGT,07-Apr-2021,,"1,000.00","5,188.25","TRANSFER BETWEEN CUSTOMERS Via USSD GTBank Transfer 000000003410316283681097656900000010002021 04071246  from MUNDU HAUWA, MOHAMMED  to ASHAFA IBRAHIM ABDULLAHI",SAVINGS ACCOUNT,GT_Bank,./static/raw/MR_IBRAHIM_ASHAFA_STATEMENT.pdf,TRANSFER BETWEEN CUSTOMERS Via USSD GTBank Transfer from MUNDU HAUWA MOHAMMED to ASHAFA IBRAHIM ABDULLAHI,TRANSFER BETWEEN CUSTOMERS Via USSD GTBank Transfer from MUNDU HAUWA MOHAMMED to ASHAFA IBRAHIM ABDULLAHI,transfert
07-Apr-2021,'0USAT,07-Apr-2021,"1,000.00",,"4,188.25",Airtime Purchase GTWORLD_QL- 101CT0000000002497384673-2348038673032,SAVINGS ACCOUNT,GT_Bank,./static/raw/MR_IBRAHIM_ASHAFA_STATEMENT.pdf,Airtime Purchase GTWORLD_QL CT,Airtime Purchase GTWORLDQL CT,utility
07-Apr-2021,'0GAPS,07-Apr-2021,,"71,250.00","75,438.25",TRANSFER BETWEEN CUSTOMERS via GAPS com on Adenola M 3M sales 111064050 0 from NETCONSTRUCT NIGERIA LIMITED to ASHAFA IBRAHIM ABDULLAHIREF: 0005628626111064050000000,SAVINGS ACCOUNT,GT_Bank,./static/raw/MR_IBRAHIM_ASHAFA_STATEMENT.pdf,TRANSFER BETWEEN CUSTOMERS via GAPS com on Adenola M M sales from NETCONSTRUCT NIGERIA LIMITED to ASHAFA IBRAHIM ABDULLAHIREF,TRANSFER BETWEEN CUSTOMERS via GAPS com on AdenolaM sales from NETCONSTRUCT NIGERIA LIMITED to ASHAFA IBRAHIM ABDULLAHIREF,transfert
07-Apr-2021,'0USGT,07-Apr-2021,,"70,000.00","145,438.25","TRANSFER BETWEEN CUSTOMERS Via USSDGTBank Transfer00000000341031628368109765690000070000202104071514  from MUNDU HAUWA, MOHAMMED  toASHAFA IBRAHIM ABDULLAHI",SAVINGS ACCOUNT,GT_Bank,./static/raw/MR_IBRAHIM_ASHAFA_STATEMENT.pdf,TRANSFER BETWEEN CUSTOMERS Via USSDGTBank Transfer from MUNDU HAUWA MOHAMMED toASHAFA IBRAHIM ABDULLAHI,TRANSFER BETWEEN CUSTOMERS Via USSDGTBank Transfer from MUNDU HAUWA MOHAMMED toASHAFA IBRAHIM ABDULLAHI,transfert
07-Apr-2021,'99990051619999,07-Apr-2021,"70,500.00",,"74,938.25",CASH WITHDRAWAL FROM OTHER ATM  -005161- -011663-PAYCOM NIG LTD (OPAY)LEXANDER HOUNG,SAVINGS ACCOUNT,GT_Bank,./static/raw/MR_IBRAHIM_ASHAFA_STATEMENT.pdf,CASH WITHDRAWAL FROM OTHER ATM PAYCOM NIG LTD OPAY LEXANDER HOUNG,CASH WITHDRAWAL FROM OTHER ATM PAYCOM NIG LTD OPAY LEXANDER HOUNG,cash
07-Apr-2021,'0GAPS,07-Apr-2021,,"95,000.00","169,938.25",TRANSFER BETWEEN CUSTOMERS via GAPSAyoade Dom 4M sales 111069396 0 fromNETCONSTRUCT NIGERIA LIMITED to ASHAFAIBRAHIM ABDULLAHIREF: 0005628626111069396000000,SAVINGS ACCOUNT,GT_Bank,./static/raw/MR_IBRAHIM_ASHAFA_STATEMENT.pdf,TRANSFER BETWEEN CUSTOMERS via GAPSAyoade Dom M sales fromNETCONSTRUCT NIGERIA LIMITED to ASHAFAIBRAHIM ABDULLAHIREF,TRANSFER BETWEEN CUSTOMERS via GAPSAyoade Domsales from NETCONSTRUCT NIGERIA LIMITED to ASHAFAIBRAHIM ABDULLAHIREF,transfert
07-Apr-2021,'0NIPG,07-Apr-2021,"120,000.00",,"49,938.25",NIBSS Instant Payment Outward000013210407163145000076045766 viaGTWORLD Hauwa TO DEMIDE ENEYAMIREJEMILATU/53.75/REF:GW6819765690000012000021040716  f,SAVINGS ACCOUNT,GT_Bank,./static/raw/MR_IBRAHIM_ASHAFA_STATEMENT.pdf,NIBSS Instant Payment Outward viaGTWORLD Hauwa TO DEMIDE ENEYAMIREJEMILATU REF GW f,NIBSS Instant Payment Outward via GTWORLD Hauwa TO DEMIDE ENEYAMIREJEMILATU REF GW,transfert
07-Apr-2021,'0NIPG,07-Apr-2021,50.00,,"49,888.25",COMMISSION 000013210407163145000076045766NIP TRANSFER COMMISSION FOR000013210407163145000076045766 viaGTWORLD Hauwa TO DEMIDE ENEYAMIREJEMILATUReF:GW681976569000001200002104071630,SAVINGS ACCOUNT,GT_Bank,./static/raw/MR_IBRAHIM_ASHAFA_STATEMENT.pdf,COMMISSION NIP TRANSFER COMMISSION FOR viaGTWORLD Hauwa TO DEMIDE ENEYAMIREJEMILATUReF GW,COMMISSION NIP TRANSFER COMMISSION FOR via GTWORLD Hauwa TO DEMIDE ENEYAMIREJEMILATUReF GW,commission
07-Apr-2021,'0NIPG,07-Apr-2021,3.75,,"49,884.50",VALUE ADDED TAX000013210407163145000076045766 VAT ON NIPTRANSFER FOR000013210407163145000076045766 viaGTWORLD Hauwa TO DEMIDE ENEYAMIREJEMILATUReF:GW681976569000001200002104071630,SAVINGS ACCOUNT,GT_Bank,./static/raw/MR_IBRAHIM_ASHAFA_STATEMENT.pdf,VALUE ADDED TAX VAT ON NIPTRANSFER FOR viaGTWORLD Hauwa TO DEMIDE ENEYAMIREJEMILATUReF GW,VALUE ADDED TAX VAT ON NIPTRANSFER FOR via GTWORLD Hauwa TO DEMIDE ENEYAMIREJEMILATUReF GW,tax
07-Apr-2021,'0USGT,07-Apr-2021,,"30,000.00","79,884.50","TRANSFER BETWEEN CUSTOMERS Via USSDGTBank Transfer00000000341031628368109765690000030000202104071725  from MUNDU HAUWA, MOHAMMED  toASHAFA IBRAHIM ABDULLAHI",SAVINGS ACCOUNT,GT_Bank,./static/raw/MR_IBRAHIM_ASHAFA_STATEMENT.pdf,TRANSFER BETWEEN CUSTOMERS Via USSDGTBank Transfer from MUNDU HAUWA MOHAMMED toASHAFA IBRAHIM ABDULLAHI,TRANSFER BETWEEN CUSTOMERS Via USSDGTBank Transfer from MUNDU HAUWA MOHAMMED toASHAFA IBRAHIM ABDULLAHI,transfert
07-Apr-2021,'0NIPG,07-Apr-2021,"20,000.00",,"59,884.50",NIBSS Instant Payment Outward000013210407173501000076161809 via GTWORLD Hauwa TO DEMIDE ENEYAMIRE JEMILATU /26.875/REF:GW6819765690000002000021040717 f,SAVINGS ACCOUNT,GT_Bank,./static/raw/MR_IBRAHIM_ASHAFA_STATEMENT.pdf,NIBSS Instant Payment Outward via GTWORLD Hauwa TO DEMIDE ENEYAMIRE JEMILATU REF GW f,NIBSS Instant Payment Outward via GTWORLD Hauwa TO DEMIDE ENEYAMIRE JEMILATU REF GW,transfert
07-Apr-2021,'0NIPG,07-Apr-2021,25.00,,"59,859.50",COMMISSION 000013210407173501000076161809 NIP TRANSFER COMMISSION FOR 000013210407173501000076161809 via GTWORLD Hauwa TO DEMIDE ENEYAMIRE JEMILATU ReF:GW681976569000000200002104071733,SAVINGS ACCOUNT,GT_Bank,./static/raw/MR_IBRAHIM_ASHAFA_STATEMENT.pdf,COMMISSION NIP TRANSFER COMMISSION FOR via GTWORLD Hauwa TO DEMIDE ENEYAMIRE JEMILATU ReF GW,COMMISSION NIP TRANSFER COMMISSION FOR via GTWORLD Hauwa TO DEMIDE ENEYAMIRE JEMILATU ReF GW,commission
07-Apr-2021,'0NIPG,07-Apr-2021,1.87,,"59,857.63",VALUE ADDED TAX 000013210407173501000076161809 VAT ON NIP TRANSFER FOR 000013210407173501000076161809 via GTWORLD Hauwa TO DEMIDE ENEYAMIRE JEMILATU ReF:GW681976569000000200002104071733,SAVINGS ACCOUNT,GT_Bank,./static/raw/MR_IBRAHIM_ASHAFA_STATEMENT.pdf,VALUE ADDED TAX VAT ON NIP TRANSFER FOR via GTWORLD Hauwa TO DEMIDE ENEYAMIRE JEMILATU ReF GW,VALUE ADDED TAX VAT ON NIP TRANSFER FOR via GTWORLD Hauwa TO DEMIDE ENEYAMIRE JEMILATU ReF GW,tax
07-Apr-2021,'6888350000,07-Apr-2021,"4,000.00",,"55,857.63",POS/WEB PURCHASE TRANSACTION  -688835- - 450562-SHEMA PETROLEUM LIMI   KD KDNG,SAVINGS ACCOUNT,GT_Bank,./static/raw/MR_IBRAHIM_ASHAFA_STATEMENT.pdf,POS WEB PURCHASE TRANSACTION SHEMA PETROLEUM LIMI KD KDNG,POS WEB PURCHASE TRANSACTION SHEMA PETROLEUM LIMI KD KDNG,utility
07-Apr-2021,'0NIPG,07-Apr-2021,"5,000.00",,"50,857.63",NIBSS Instant Payment Outward 000013210407180331000076211421 via GTWORLD  TO JIBRIN BASIRAH USMAN /10.75/REF:GW6819765690000000500021040718  f,SAVINGS ACCOUNT,GT_Bank,./static/raw/MR_IBRAHIM_ASHAFA_STATEMENT.pdf,NIBSS Instant Payment Outward via GTWORLD TO JIBRIN BASIRAH USMAN REF GW f,NIBSS Instant Payment Outward via GTWORLD TO JIBRIN BASIRAH USMAN REF GW,transfert
07-Apr-2021,'0NIPG,07-Apr-2021,10.00,,"50,847.63",COMMISSION 000013210407180331000076211421 NIP TRANSFER COMMISSION FOR 000013210407180331000076211421 via GTWORLD  TO JIBRIN BASIRAH USMAN ReF:GW681976569000000050002104071801,SAVINGS ACCOUNT,GT_Bank,./static/raw/MR_IBRAHIM_ASHAFA_STATEMENT.pdf,COMMISSION NIP TRANSFER COMMISSION FOR via GTWORLD TO JIBRIN BASIRAH USMAN ReF GW,COMMISSION NIP TRANSFER COMMISSION FOR via GTWORLD TO JIBRIN BASIRAH USMAN ReF GW,commission
07-Apr-2021,'0NIPG,07-Apr-2021,.75,,"50,846.88",VALUE ADDED TAX 000013210407180331000076211421 VAT ON NIP TRANSFER FOR 000013210407180331000076211421 via GTWORLD  TO JIBRIN BASIRAH USMAN ReF:GW681976569000000050002104071801,SAVINGS ACCOUNT,GT_Bank,./static/raw/MR_IBRAHIM_ASHAFA_STATEMENT.pdf,VALUE ADDED TAX VAT ON NIP TRANSFER FOR via GTWORLD TO JIBRIN BASIRAH USMAN ReF GW,VALUE ADDED TAX VAT ON NIP TRANSFER FOR via GTWORLD TO JIBRIN BASIRAH USMAN ReF GW,tax
07-Apr-2021,'0USAT,07-Apr-2021,600.00,,"50,246.88",Airtime Purchase GTWORLD_QL- 101CT0000000002498604717-2348030549818,SAVINGS ACCOUNT,GT_Bank,./static/raw/MR_IBRAHIM_ASHAFA_STATEMENT.pdf,Airtime Purchase GTWORLD_QL CT,Airtime Purchase GTWORLDQL CT,utility
08-Apr-2021,'0,07-Apr-2021,100.00,,"50,146.88",STAMP DUTY CHARGE 07042021 STAMP DUTY CHARGE - 07/04/2021,SAVINGS ACCOUNT,GT_Bank,./static/raw/MR_IBRAHIM_ASHAFA_STATEMENT.pdf,STAMP DUTY CHARGE STAMP DUTY CHARGE,STAMP DUTY CHARGE STAMP DUTY CHARGE,bank_charges
08-Apr-2021,'99995683869999,08-Apr-2021,"30,200.00",,"19,946.88",POS/WEB PURCHASE TRANSACTION  -568386- - 533327-AGENCY/TRF-ACC/POS     GARKI2 NG,SAVINGS ACCOUNT,GT_Bank,./static/raw/MR_IBRAHIM_ASHAFA_STATEMENT.pdf,POS WEB PURCHASE TRANSACTION AGENCY TRF ACC POS GARKI NG,POS WEB PURCHASE TRANSACTION AGENCY TRF ACC POS GARKI NG,utility
08-Apr-2021,'0NIPG,08-Apr-2021,"5,500.00",,"14,446.88",NIBSS Instant Payment Outward 000013210408175306000077825150 via GTWORLD  TO MUHAMMAD IBRAHIM ARAB /26.875/REF:GW6819765690000000550021040817 f,SAVINGS ACCOUNT,GT_Bank,./static/raw/MR_IBRAHIM_ASHAFA_STATEMENT.pdf,NIBSS Instant Payment Outward via GTWORLD TO MUHAMMAD IBRAHIM ARAB REF GW f,NIBSS Instant Payment Outward via GTWORLD TO MUHAMMAD IBRAHIM ARAB REF GW,transfert
08-Apr-2021,'0NIPG,08-Apr-2021,25.00,,"14,421.88",COMMISSION 000013210408175306000077825150 NIP TRANSFER COMMISSION FOR 000013210408175306000077825150 via GTWORLD  TO MUHAMMAD IBRAHIM ARAB ReF:GW681976569000000055002104081751,SAVINGS ACCOUNT,GT_Bank,./static/raw/MR_IBRAHIM_ASHAFA_STATEMENT.pdf,COMMISSION NIP TRANSFER COMMISSION FOR via GTWORLD TO MUHAMMAD IBRAHIM ARAB ReF GW,COMMISSION NIP TRANSFER COMMISSION FOR via GTWORLD TO MUHAMMAD IBRAHIM ARAB ReF GW,commission
08-Apr-2021,'0NIPG,08-Apr-2021,1.87,,"14,420.01",VALUE ADDED TAX 000013210408175306000077825150 VAT ON NIP TRANSFER FOR 000013210408175306000077825150 via GTWORLD  TO MUHAMMAD IBRAHIM ARAB ReF:GW681976569000000055002104081751,SAVINGS ACCOUNT,GT_Bank,./static/raw/MR_IBRAHIM_ASHAFA_STATEMENT.pdf,VALUE ADDED TAX VAT ON NIP TRANSFER FOR via GTWORLD TO MUHAMMAD IBRAHIM ARAB ReF GW,VALUE ADDED TAX VAT ON NIP TRANSFER FOR via GTWORLD TO MUHAMMAD IBRAHIM ARAB ReF GW,tax
08-Apr-2021,'0NIPG,08-Apr-2021,"3,000.00",,"11,420.01",NIBSS Instant Payment Outward 000013210408193345000077997235 via GTWORLD  TO OGA ABDULLAHI ALIYU /10.75/REF:GW6819765690000000300021040819  f,SAVINGS ACCOUNT,GT_Bank,./static/raw/MR_IBRAHIM_ASHAFA_STATEMENT.pdf,NIBSS Instant Payment Outward via GTWORLD TO OGA ABDULLAHI ALIYU REF GW f,NIBSS Instant Payment Outward via GTWORLD TO OGA ABDULLAHI ALIYU REF GW,transfert
08-Apr-2021,'0NIPG,08-Apr-2021,10.00,,"11,410.01",COMMISSION 000013210408193345000077997235 NIP TRANSFER COMMISSION FOR 000013210408193345000077997235 via GTWORLD  TO OGA ABDULLAHI ALIYU ReF:GW681976569000000030002104081932,SAVINGS ACCOUNT,GT_Bank,./static/raw/MR_IBRAHIM_ASHAFA_STATEMENT.pdf,COMMISSION NIP TRANSFER COMMISSION FOR via GTWORLD TO OGA ABDULLAHI ALIYU ReF GW,COMMISSION NIP TRANSFER COMMISSION FOR via GTWORLD TO OGA ABDULLAHI ALIYU ReF GW,commission
08-Apr-2021,'0NIPG,08-Apr-2021,.75,,"11,409.26",VALUE ADDED TAX 000013210408193345000077997235 VAT ON NIP TRANSFER FOR 000013210408193345000077997235 via GTWORLD  TO OGA ABDULLAHI ALIYU ReF:GW681976569000000030002104081932,SAVINGS ACCOUNT,GT_Bank,./static/raw/MR_IBRAHIM_ASHAFA_STATEMENT.pdf,VALUE ADDED TAX VAT ON NIP TRANSFER FOR via GTWORLD TO OGA ABDULLAHI ALIYU ReF GW,VALUE ADDED TAX VAT ON NIP TRANSFER FOR via GTWORLD TO OGA ABDULLAHI ALIYU ReF GW,tax
09-Apr-2021,'1841730000,09-Apr-2021,"10,000.00",,"1,409.26",POS/WEB PURCHASE TRANSACTION  -184173- - 431964-SHEMA PETROLEUM LIMI   KDKDNG,SAVINGS ACCOUNT,GT_Bank,./static/raw/MR_IBRAHIM_ASHAFA_STATEMENT.pdf,POS WEB PURCHASE TRANSACTION SHEMA PETROLEUM LIMI KDKDNG,POS WEB PURCHASE TRANSACTION SHEMA PETROLEUM LIMI KDKDNG,utility
09-Apr-2021,'0NIPT,09-Apr-2021,,"100,000.00","101,409.26",TRANSFER BETWEEN CUSTOMERS 000026210409144702000003740104|NIP/TRF IFO ASHAFA IBRAHIM ABDULLAHI BO IBRAHIM AS|STAJJNG21040906040166||0000074655 REF:000026210409144702000003740104,SAVINGS ACCOUNT,GT_Bank,./static/raw/MR_IBRAHIM_ASHAFA_STATEMENT.pdf,TRANSFER BETWEEN CUSTOMERS NIP TRF IFO ASHAFA IBRAHIM ABDULLAHI BO IBRAHIM AS STAJJNG REF,TRANSFER BETWEEN CUSTOMERS NIP TRF IFO ASHAFA IBRAHIM ABDULLAHI BO IBRAHIM AS STAJJNG REF,transfert
09-Apr-2021,'0USAT,09-Apr-2021,800.00,,"100,609.26",Airtime Purchase GTWORLD_QL- 101CT0000000002503671902-2348038673032,SAVINGS ACCOUNT,GT_Bank,./static/raw/MR_IBRAHIM_ASHAFA_STATEMENT.pdf,Airtime Purchase GTWORLD_QL CT,Airtime Purchase GTWORLDQL CT,utility
10-Apr-2021,'0,09-Apr-2021,50.00,,"100,559.26",STAMP DUTY CHARGE 09042021 STAMP DUTY CHARGE - 09/04/2021,SAVINGS ACCOUNT,GT_Bank,./static/raw/MR_IBRAHIM_ASHAFA_STATEMENT.pdf,STAMP DUTY CHARGE STAMP DUTY CHARGE,STAMP DUTY CHARGE STAMP DUTY CHARGE,bank_charges
10-Apr-2021,'0GWTR,10-Apr-2021,"4,000.00",,"96,559.26","TRANSFER BETWEEN CUSTOMERS Via GTWorld REF:681976569000000040002104101102  from ASHAFA IBRAHIM ABDULLAHI  to  ABDULLATIF, RUKAYYA",SAVINGS ACCOUNT,GT_Bank,./static/raw/MR_IBRAHIM_ASHAFA_STATEMENT.pdf,TRANSFER BETWEEN CUSTOMERS Via GTWorld REF from ASHAFA IBRAHIM ABDULLAHI to ABDULLATIF RUKAYYA,TRANSFER BETWEEN CUSTOMERS Via GTWorld REF from ASHAFA IBRAHIM ABDULLAHI to ABDULLATIF RUKAYYA,transfert
10-Apr-2021,'99990061369999,10-Apr-2021,"10,300.00",,"86,259.26",FUNDS TRANSFER  -006136- -429221-T006136 2TEPF117       LA           LANG,SAVINGS ACCOUNT,GT_Bank,./static/raw/MR_IBRAHIM_ASHAFA_STATEMENT.pdf,FUNDS TRANSFER T TEPF LA LANG,FUNDS TRANSFERTEPF LA LANG,utility
10-Apr-2021,'0NIPG,10-Apr-2021,"3,000.00",,"83,259.26",NIBSS Instant Payment Outward 000013210410113030000080319332 via GTWORLD  TO MUHAMMAD ISMAIL RABO /10.75/REF:GW6819765690000000300021041011  f,SAVINGS ACCOUNT,GT_Bank,./static/raw/MR_IBRAHIM_ASHAFA_STATEMENT.pdf,NIBSS Instant Payment Outward via GTWORLD TO MUHAMMAD ISMAIL RABO REF GW f,NIBSS Instant Payment Outward via GTWORLD TO MUHAMMAD ISMAIL RABO REF GW,transfert
10-Apr-2021,'0NIPG,10-Apr-2021,10.00,,"83,249.26",COMMISSION 000013210410113030000080319332 NIP TRANSFER COMMISSION FOR 000013210410113030000080319332 via GTWORLD  TO MUHAMMAD ISMAIL RABO ReF:GW681976569000000030002104101128,SAVINGS ACCOUNT,GT_Bank,./static/raw/MR_IBRAHIM_ASHAFA_STATEMENT.pdf,COMMISSION NIP TRANSFER COMMISSION FOR via GTWORLD TO MUHAMMAD ISMAIL RABO ReF GW,COMMISSION NIP TRANSFER COMMISSION FOR via GTWORLD TO MUHAMMAD ISMAIL RABO ReF GW,commission
10-Apr-2021,'0NIPG,10-Apr-2021,.75,,"83,248.51",VALUE ADDED TAX 000013210410113030000080319332 VAT ON NIP TRANSFER FOR 000013210410113030000080319332 via GTWORLD  TO MUHAMMAD ISMAIL RABO ReF:GW681976569000000030002104101128,SAVINGS ACCOUNT,GT_Bank,./static/raw/MR_IBRAHIM_ASHAFA_STATEMENT.pdf,VALUE ADDED TAX VAT ON NIP TRANSFER FOR via GTWORLD TO MUHAMMAD ISMAIL RABO ReF GW,VALUE ADDED TAX VAT ON NIP TRANSFER FOR via GTWORLD TO MUHAMMAD ISMAIL RABO ReF GW,tax
10-Apr-2021,'0USAT,10-Apr-2021,"1,000.00",,"82,248.51",Airtime Purchase GTWORLD_QL- 101CT0000000002505492836-2348038673032,SAVINGS ACCOUNT,GT_Bank,./static/raw/MR_IBRAHIM_ASHAFA_STATEMENT.pdf,Airtime Purchase GTWORLD_QL CT,Airtime Purchase GTWORLDQL CT,utility
10-Apr-2021,'0NIPG,10-Apr-2021,"2,000.00",,"80,248.51",NIBSS Instant Payment Outward 000013210410220609000081261167 via GTWORLD  TO UTHMAN BALA AHMED /10.75/REF:GW6819765690000000200021041022  f,SAVINGS ACCOUNT,GT_Bank,./static/raw/MR_IBRAHIM_ASHAFA_STATEMENT.pdf,NIBSS Instant Payment Outward via GTWORLD TO UTHMAN BALA AHMED REF GW f,NIBSS Instant Payment Outward via GTWORLD TO UTHMAN BALA AHMED REF GW,transfert
10-Apr-2021,'0NIPG,10-Apr-2021.1,10.00,,"80,238.51",COMMISSION 000013210410220609000081261167 NIP TRANSFER COMMISSION FOR 000013210410220609000081261167 via GTWORLD  TO UTHMAN BALA AHMED ReF:GW681976569000000020002104102204,SAVINGS ACCOUNT,GT_Bank,./static/raw/MR_IBRAHIM_ASHAFA_STATEMENT.pdf,COMMISSION NIP TRANSFER COMMISSION FOR via GTWORLD TO UTHMAN BALA AHMED ReF GW,COMMISSION NIP TRANSFER COMMISSION FOR via GTWORLD TO UTHMAN BALA AHMED ReF GW,commission
10-Apr-2021,'0NIPG,10-Apr-2021,.75,,"80,237.76",VALUE ADDED TAX 000013210410220609000081261167 VAT ON NIP TRANSFER FOR 000013210410220609000081261167 via GTWORLD  TO UTHMAN BALA AHMED ReF:GW681976569000000020002104102204,SAVINGS ACCOUNT,GT_Bank,./static/raw/MR_IBRAHIM_ASHAFA_STATEMENT.pdf,VALUE ADDED TAX VAT ON NIP TRANSFER FOR via GTWORLD TO UTHMAN BALA AHMED ReF GW,VALUE ADDED TAX VAT ON NIP TRANSFER FOR via GTWORLD TO UTHMAN BALA AHMED ReF GW,tax
11-Apr-2021,'0GWTR,11-Apr-2021,"70,000.00",,"10,237.76",TRANSFER BETWEEN CUSTOMERS Via GTWorld REF:681976569000000700002104111421  from ASHAFA IBRAHIM ABDULLAHI  to  SULEIMAN ALIYU,SAVINGS ACCOUNT,GT_Bank,./static/raw/MR_IBRAHIM_ASHAFA_STATEMENT.pdf,TRANSFER BETWEEN CUSTOMERS Via GTWorld REF from ASHAFA IBRAHIM ABDULLAHI to SULEIMAN ALIYU,TRANSFER BETWEEN CUSTOMERS Via GTWorld REF from ASHAFA IBRAHIM ABDULLAHI to SULEIMAN ALIYU,transfert
11-Apr-2021,'0USAT,11-Apr-2021,800.00,,"9,437.76",Airtime Purchase GTWORLD_QL- 101CT0000000002508421151-2348038673032,SAVINGS ACCOUNT,GT_Bank,./static/raw/MR_IBRAHIM_ASHAFA_STATEMENT.pdf,Airtime Purchase GTWORLD_QL CT,Airtime Purchase GTWORLDQL CT,utility
11-Apr-2021,'0GWTR,11-Apr-2021,200.00,,"9,237.76",TRANSFER BETWEEN CUSTOMERS Via GTWorld REF:681976569000000002002104112015  from ASHAFA IBRAHIM ABDULLAHI  to  MUHAMMAD ISMAIL RABO,SAVINGS ACCOUNT,GT_Bank,./static/raw/MR_IBRAHIM_ASHAFA_STATEMENT.pdf,TRANSFER BETWEEN CUSTOMERS Via GTWorld REF from ASHAFA IBRAHIM ABDULLAHI to MUHAMMAD ISMAIL RABO,TRANSFER BETWEEN CUSTOMERS Via GTWorld REF from ASHAFA IBRAHIM ABDULLAHI to MUHAMMAD ISMAIL RABO,transfert
12-Apr-2021,'0NIPT,12-Apr-2021,,"30,000.00","39,237.76",TRANSFER BETWEEN CUSTOMERS 000026210412081354000003792573|NIP/TRF IFO ASHAFA IBRAHIM ABDULLAHI BO IBRAHIM AS|STAJJNG21041206122954||IBRAHIM ASHAFA REF:000026210412081354000003792573,SAVINGS ACCOUNT,GT_Bank,./static/raw/MR_IBRAHIM_ASHAFA_STATEMENT.pdf,TRANSFER BETWEEN CUSTOMERS NIP TRF IFO ASHAFA IBRAHIM ABDULLAHI BO IBRAHIM AS STAJJNG IBRAHIM ASHAFA REF,TRANSFER BETWEEN CUSTOMERS NIP TRF IFO ASHAFA IBRAHIM ABDULLAHI BO IBRAHIM AS STAJJNG IBRAHIM ASHAFA REF,transfert
12-Apr-2021,'0GWTR,12-Apr-2021,"2,100.00",,"37,137.76","TRANSFER BETWEEN CUSTOMERS Via GTWorld REF:681976569000000021002104120915  from ASHAFA IBRAHIM ABDULLAHI  to  ABDULLATIF, RUKAYYA",SAVINGS ACCOUNT,GT_Bank,./static/raw/MR_IBRAHIM_ASHAFA_STATEMENT.pdf,TRANSFER BETWEEN CUSTOMERS Via GTWorld REF from ASHAFA IBRAHIM ABDULLAHI to ABDULLATIF RUKAYYA,TRANSFER BETWEEN CUSTOMERS Via GTWorld REF from ASHAFA IBRAHIM ABDULLAHI to ABDULLATIF RUKAYYA,transfert
12-Apr-2021,'99993410299999,12-Apr-2021,35.00,,"37,102.76",ATM WITHDRAWAL COMMISSION  -341029- - 063925-000000000000932 Boling Abuja          NG,SAVINGS ACCOUNT,GT_Bank,./static/raw/MR_IBRAHIM_ASHAFA_STATEMENT.pdf,ATM WITHDRAWAL COMMISSION Boling Abuja NG,ATM WITHDRAWAL COMMISSION Boling Abuja NG,utility
12-Apr-2021,'99993410299999,12-Apr-2021,"7,000.00",,"30,102.76",CASH WITHDRAWAL FROM OTHER ATM  - 341029- -063925-000000000000932 Boling Abuja NG,SAVINGS ACCOUNT,GT_Bank,./static/raw/MR_IBRAHIM_ASHAFA_STATEMENT.pdf,CASH WITHDRAWAL FROM OTHER ATM Boling Abuja NG,CASH WITHDRAWAL FROM OTHER ATM Boling Abuja NG,cash
12-Apr-2021,'0NIPG,12-Apr-2021,"7,000.00",,"23,102.76",NIBSS Instant Payment Outward 000013210412111631000082855658 via GTWORLD  TO YUNUSA SALEE SALIFU/26.875/REF:GW6819765690000000700021041211 f,SAVINGS ACCOUNT,GT_Bank,./static/raw/MR_IBRAHIM_ASHAFA_STATEMENT.pdf,NIBSS Instant Payment Outward via GTWORLD TO YUNUSA SALEE SALIFU REF GW f,NIBSS Instant Payment Outward via GTWORLD TO YUNUSA SALEE SALIFU REF GW,transfert
12-Apr-2021,'0NIPG,12-Apr-2021,25.00,,"23,077.76",COMMISSION 000013210412111631000082855658 NIP TRANSFER COMMISSION FOR 000013210412111631000082855658 via GTWORLD  TO YUNUSA SALEE SALIFU ReF:GW681976569000000070002104121114,SAVINGS ACCOUNT,GT_Bank,./static/raw/MR_IBRAHIM_ASHAFA_STATEMENT.pdf,COMMISSION NIP TRANSFER COMMISSION FOR via GTWORLD TO YUNUSA SALEE SALIFU ReF GW,COMMISSION NIP TRANSFER COMMISSION FOR via GTWORLD TO YUNUSA SALEE SALIFU ReF GW,commission
12-Apr-2021,'0NIPG,12-Apr-2021,1.87,,"23,075.89",VALUE ADDED TAX 000013210412111631000082855658 VAT ON NIP TRANSFER FOR 000013210412111631000082855658 via GTWORLD  TO YUNUSA SALEE SALIFU ReF:GW681976569000000070002104121114,SAVINGS ACCOUNT,GT_Bank,./static/raw/MR_IBRAHIM_ASHAFA_STATEMENT.pdf,VALUE ADDED TAX VAT ON NIP TRANSFER FOR via GTWORLD TO YUNUSA SALEE SALIFU ReF GW,VALUE ADDED TAX VAT ON NIP TRANSFER FOR via GTWORLD TO YUNUSA SALEE SALIFU ReF GW,tax
12-Apr-2021,'0NIPG,12-Apr-2021,"8,000.00",,"15,075.89",NIBSS Instant Payment Outward 000013210412193401000083764560 via GTWORLD  TO ADELEKE ABOSEDE HANNAH /26.875/REF:GW6819765690000000800021041219 f,SAVINGS ACCOUNT,GT_Bank,./static/raw/MR_IBRAHIM_ASHAFA_STATEMENT.pdf,NIBSS Instant Payment Outward via GTWORLD TO ADELEKE ABOSEDE HANNAH REF GW f,NIBSS Instant Payment Outward via GTWORLD TO ADELEKE ABOSEDE HANNAH REF GW,transfert
12-Apr-2021,'0NIPG,12-Apr-2021,25.00,,"15,050.89",COMMISSION 000013210412193401000083764560 NIP TRANSFER COMMISSION FOR 000013210412193401000083764560 via GTWORLD  TO ADELEKE ABOSEDE HANNAH ReF:GW681976569000000080002104121932,SAVINGS ACCOUNT,GT_Bank,./static/raw/MR_IBRAHIM_ASHAFA_STATEMENT.pdf,COMMISSION NIP TRANSFER COMMISSION FOR via GTWORLD TO ADELEKE ABOSEDE HANNAH ReF GW,COMMISSION NIP TRANSFER COMMISSION FOR via GTWORLD TO ADELEKE ABOSEDE HANNAH ReF GW,commission
12-Apr-2021,'0NIPG,12-Apr-2021,1.87,,"15,049.02",VALUE ADDED TAX 000013210412193401000083764560 VAT ON NIP TRANSFER FOR 000013210412193401000083764560 via GTWORLD  TO ADELEKE ABOSEDE HANNAH ReF:GW681976569000000080002104121932,SAVINGS ACCOUNT,GT_Bank,./static/raw/MR_IBRAHIM_ASHAFA_STATEMENT.pdf,VALUE ADDED TAX VAT ON NIP TRANSFER FOR via GTWORLD TO ADELEKE ABOSEDE HANNAH ReF GW,VALUE ADDED TAX VAT ON NIP TRANSFER FOR via GTWORLD TO ADELEKE ABOSEDE HANNAH ReF GW,tax
13-Apr-2021,'0,12-Apr-2021,50.00,,"14,999.02",STAMP DUTY CHARGE 12042021 STAMP DUTY CHARGE - 12/04/2021,SAVINGS ACCOUNT,GT_Bank,./static/raw/MR_IBRAHIM_ASHAFA_STATEMENT.pdf,STAMP DUTY CHARGE STAMP DUTY CHARGE,STAMP DUTY CHARGE STAMP DUTY CHARGE,bank_charges
13-Apr-2021,'99990036469999,13-Apr-2021,"4,600.00",,"10,399.02",FUNDS TRANSFER  -003646- -292047-T003646 2TGTFD88       LA           LANG,SAVINGS ACCOUNT,GT_Bank,./static/raw/MR_IBRAHIM_ASHAFA_STATEMENT.pdf,FUNDS TRANSFER T TGTFD LA LANG,FUNDS TRANSFERTGTFD LA LANG,utility
14-Apr-2021,'0NIPG,14-Apr-2021,"5,000.00",,"5,399.02",NIBSS Instant Payment Outward 000013210414055053000085755612 via GTWORLD  TO YUSUF HASSAN /10.75/REF:GW6819765690000000500021041405  f,SAVINGS ACCOUNT,GT_Bank,./static/raw/MR_IBRAHIM_ASHAFA_STATEMENT.pdf,NIBSS Instant Payment Outward via GTWORLD TO YUSUF HASSAN REF GW f,NIBSS Instant Payment Outward via GTWORLD TO YUSUF HASSAN REF GW,transfert
14-Apr-2021,'0NIPG,14-Apr-2021,10.00,,"5,389.02",COMMISSION 000013210414055053000085755612NIP TRANSFER COMMISSION FOR000013210414055053000085755612 viaGTWORLD  TO YUSUF HASSANReF:GW681976569000000050002104140549,SAVINGS ACCOUNT,GT_Bank,./static/raw/MR_IBRAHIM_ASHAFA_STATEMENT.pdf,COMMISSION NIP TRANSFER COMMISSION FOR viaGTWORLD TO YUSUF HASSANReF GW,COMMISSION NIP TRANSFER COMMISSION FOR via GTWORLD TO YUSUF HASSANReF GW,commission
14-Apr-2021,'0NIPG,14-Apr-2021,.75,,"5,388.27",VALUE ADDED TAX000013210414055053000085755612 VAT ON NIPTRANSFER FOR000013210414055053000085755612 viaGTWORLD  TO YUSUF HASSANReF:GW681976569000000050002104140549,SAVINGS ACCOUNT,GT_Bank,./static/raw/MR_IBRAHIM_ASHAFA_STATEMENT.pdf,VALUE ADDED TAX VAT ON NIPTRANSFER FOR viaGTWORLD TO YUSUF HASSANReF GW,VALUE ADDED TAX VAT ON NIPTRANSFER FOR via GTWORLD TO YUSUF HASSANReF GW,tax
14-Apr-2021,'0NIPT,14-Apr-2021,,"20,000.00","25,388.27",TRANSFER BETWEEN CUSTOMERS000004210414082831001116535248|USSD-NIP/ToASHAFAA./23480XXXX9995|2348038509995/1116535248||ABDULLAHI ASHAFAREF:000004210414082831001116535248,SAVINGS ACCOUNT,GT_Bank,./static/raw/MR_IBRAHIM_ASHAFA_STATEMENT.pdf,TRANSFER BETWEEN CUSTOMERS USSD NIP ToASHAFAA XXXX ABDULLAHI ASHAFAREF,TRANSFER BETWEEN CUSTOMERS USSD NIP ToASHAFAA XXXX ABDULLAHI ASHAFAREF,transfert
14-Apr-2021,'0NIPG,14-Apr-2021,"22,000.00",,"3,388.27",NIBSS Instant Payment Outward000013210414151600000086626669 viaGTWORLD  TO USMAN  BABANGIDA/26.875/REF:GW6819765690000002200021041415f,SAVINGS ACCOUNT,GT_Bank,./static/raw/MR_IBRAHIM_ASHAFA_STATEMENT.pdf,NIBSS Instant Payment Outward viaGTWORLD TO USMAN BABANGIDA REF GW f,NIBSS Instant Payment Outward via GTWORLD TO USMAN BABANGIDA REF GW,transfert
14-Apr-2021,'0NIPG,14-Apr-2021,25.00,,"3,363.27",COMMISSION 000013210414151600000086626669NIP TRANSFER COMMISSION FOR000013210414151600000086626669 viaGTWORLD  TO USMAN  BABANGIDAReF:GW681976569000000220002104141514,SAVINGS ACCOUNT,GT_Bank,./static/raw/MR_IBRAHIM_ASHAFA_STATEMENT.pdf,COMMISSION NIP TRANSFER COMMISSION FOR viaGTWORLD TO USMAN BABANGIDAReF GW,COMMISSION NIP TRANSFER COMMISSION FOR via GTWORLD TO USMAN BABANGIDAReF GW,commission
14-Apr-2021,'0NIPG,14-Apr-2021,1.87,,"3,361.40",VALUE ADDED TAX000013210414151600000086626669 VAT ON NIPTRANSFER FOR000013210414151600000086626669 viaGTWORLD  TO USMAN  BABANGIDAReF:GW681976569000000220002104141514,SAVINGS ACCOUNT,GT_Bank,./static/raw/MR_IBRAHIM_ASHAFA_STATEMENT.pdf,VALUE ADDED TAX VAT ON NIPTRANSFER FOR viaGTWORLD TO USMAN BABANGIDAReF GW,VALUE ADDED TAX VAT ON NIPTRANSFER FOR via GTWORLD TO USMAN BABANGIDAReF GW,tax
14-Apr-2021,'99990021039999,14-Apr-2021,"3,100.00",,261.40,FUNDS TRANSFER  -002103- -039024-T0021032TGTCS50LALANG,SAVINGS ACCOUNT,GT_Bank,./static/raw/MR_IBRAHIM_ASHAFA_STATEMENT.pdf,FUNDS TRANSFER T TGTCS LALANG,FUNDS TRANSFERTGTCS LALANG,loan
14-Apr-2021,'0,14-Apr-2021,50.00,,211.40,STAMP DUTY CHARGE 14042021 STAMP DUTYCHARGE - 14/04/2021,SAVINGS ACCOUNT,GT_Bank,./static/raw/MR_IBRAHIM_ASHAFA_STATEMENT.pdf,STAMP DUTY CHARGE STAMP DUTYCHARGE,STAMP DUTY CHARGE STAMP DUTYCHARGE,bank_charges
15-Apr-2021,'0NIPT,15-Apr-2021,,"100,000.00","100,211.40",TRANSFER BETWEEN CUSTOMERS000026210415101759000003861618|NIP/TRF IFOASHAFA IBRAHIM ABDULLAHI BO IBRAHIM AS|STAJJNG21041506235073||IBRAHIM ASHAFA REF:000026210415101759000003861618,SAVINGS ACCOUNT,GT_Bank,./static/raw/MR_IBRAHIM_ASHAFA_STATEMENT.pdf,TRANSFER BETWEEN CUSTOMERS NIP TRF IFOASHAFA IBRAHIM ABDULLAHI BO IBRAHIM AS STAJJNG IBRAHIM ASHAFA REF,TRANSFER BETWEEN CUSTOMERS NIP TRF IFOASHAFA IBRAHIM ABDULLAHI BO IBRAHIM AS STAJJNG IBRAHIM ASHAFA REF,transfert
15-Apr-2021,'0NIPG,15-Apr-2021,"20,000.00",,"80,211.40",NIBSS Instant Payment Outward 000013210415102916000087674846 via GTWORLD  TO ABDULLAHI ASHAFA /26.875/REF:GW6819765690000002000021041510 f,SAVINGS ACCOUNT,GT_Bank,./static/raw/MR_IBRAHIM_ASHAFA_STATEMENT.pdf,NIBSS Instant Payment Outward via GTWORLD TO ABDULLAHI ASHAFA REF GW f,NIBSS Instant Payment Outward via GTWORLD TO ABDULLAHI ASHAFA REF GW,transfert
15-Apr-2021,'0NIPG,15-Apr-2021,25.00,,"80,186.40",COMMISSION 000013210415102916000087674846 NIP TRANSFER COMMISSION FOR 000013210415102916000087674846 via GTWORLD  TO ABDULLAHI ASHAFA ReF:GW681976569000000200002104151027,SAVINGS ACCOUNT,GT_Bank,./static/raw/MR_IBRAHIM_ASHAFA_STATEMENT.pdf,COMMISSION NIP TRANSFER COMMISSION FOR via GTWORLD TO ABDULLAHI ASHAFA ReF GW,COMMISSION NIP TRANSFER COMMISSION FOR via GTWORLD TO ABDULLAHI ASHAFA ReF GW,commission
15-Apr-2021,'0NIPG,15-Apr-2021,1.87,,"80,184.53",VALUE ADDED TAX 000013210415102916000087674846 VAT ON NIP TRANSFER FOR 000013210415102916000087674846 via GTWORLD  TO ABDULLAHI ASHAFA ReF:GW681976569000000200002104151027,SAVINGS ACCOUNT,GT_Bank,./static/raw/MR_IBRAHIM_ASHAFA_STATEMENT.pdf,VALUE ADDED TAX VAT ON NIP TRANSFER FOR via GTWORLD TO ABDULLAHI ASHAFA ReF GW,VALUE ADDED TAX VAT ON NIP TRANSFER FOR via GTWORLD TO ABDULLAHI ASHAFA ReF GW,tax
15-Apr-2021,'0GWTR,15-Apr-2021,"40,000.00",,"40,184.53",TRANSFER BETWEEN CUSTOMERS Via GTWorld REF:681976569000000400002104151029  from ASHAFA IBRAHIM ABDULLAHI  to  SULEIMAN ALIYU,SAVINGS ACCOUNT,GT_Bank,./static/raw/MR_IBRAHIM_ASHAFA_STATEMENT.pdf,TRANSFER BETWEEN CUSTOMERS Via GTWorld REF from ASHAFA IBRAHIM ABDULLAHI to SULEIMAN ALIYU,TRANSFER BETWEEN CUSTOMERS Via GTWorld REF from ASHAFA IBRAHIM ABDULLAHI to SULEIMAN ALIYU,transfert
15-Apr-2021,'0NIPG,15-Apr-2021,"8,000.00",,"32,184.53",NIBSS Instant Payment Outward 000013210415104142000087697412 via GTWORLD  TO JIBRIN BASIRAH USMAN /26.875/REF:GW6819765690000000800021041510 f,SAVINGS ACCOUNT,GT_Bank,./static/raw/MR_IBRAHIM_ASHAFA_STATEMENT.pdf,NIBSS Instant Payment Outward via GTWORLD TO JIBRIN BASIRAH USMAN REF GW f,NIBSS Instant Payment Outward via GTWORLD TO JIBRIN BASIRAH USMAN REF GW,transfert
15-Apr-2021,'0NIPG,15-Apr-2021,25.00,,"32,159.53",COMMISSION 000013210415104142000087697412 NIP TRANSFER COMMISSION FOR 000013210415104142000087697412 via GTWORLD  TO JIBRIN BASIRAH USMAN ReF:GW681976569000000080002104151039,SAVINGS ACCOUNT,GT_Bank,./static/raw/MR_IBRAHIM_ASHAFA_STATEMENT.pdf,COMMISSION NIP TRANSFER COMMISSION FOR via GTWORLD TO JIBRIN BASIRAH USMAN ReF GW,COMMISSION NIP TRANSFER COMMISSION FOR via GTWORLD TO JIBRIN BASIRAH USMAN ReF GW,commission
15-Apr-2021,'0NIPG,15-Apr-2021,1.87,,"32,157.66",VALUE ADDED TAX 000013210415104142000087697412 VAT ON NIP TRANSFER FOR 000013210415104142000087697412 via GTWORLD  TO JIBRIN BASIRAH USMAN ReF:GW681976569000000080002104151039,SAVINGS ACCOUNT,GT_Bank,./static/raw/MR_IBRAHIM_ASHAFA_STATEMENT.pdf,VALUE ADDED TAX VAT ON NIP TRANSFER FOR via GTWORLD TO JIBRIN BASIRAH USMAN ReF GW,VALUE ADDED TAX VAT ON NIP TRANSFER FOR via GTWORLD TO JIBRIN BASIRAH USMAN ReF GW,tax
15-Apr-2021,'0USAT,15-Apr-2021.1,"1,000.00",,"31,157.66",Airtime Purchase GTWORLD- 101CT0000000002517180333-2348038673032,SAVINGS ACCOUNT,GT_Bank,./static/raw/MR_IBRAHIM_ASHAFA_STATEMENT.pdf,Airtime Purchase GTWORLD CT,Airtime Purchase GTWORLD CT,utility
15-Apr-2021,'99996678819999,15-Apr-2021,100.00,,"31,057.66",PURCHASE/TRANSFER COMMISSION  -667881- - 665816-WT|AREMU SHOLA                  ABUJA NG,SAVINGS ACCOUNT,GT_Bank,./static/raw/MR_IBRAHIM_ASHAFA_STATEMENT.pdf,PURCHASE TRANSFER COMMISSION WT AREMU SHOLA ABUJA NG,PURCHASE TRANSFER COMMISSION WT AREMU SHOLA ABUJA NG,transfert
15-Apr-2021,'99996678819999,15-Apr-2021,"9,900.00",,"21,157.66",ATM/POS ACOUNT TO ACCOUNT TRANSFER  - 667881- -665816-WT|AREMU SHOLA ABUJA NG,SAVINGS ACCOUNT,GT_Bank,./static/raw/MR_IBRAHIM_ASHAFA_STATEMENT.pdf,ATM POS ACOUNT TO ACCOUNT TRANSFER WT AREMU SHOLA ABUJA NG,ATM POS ACOUNT TO ACCOUNT TRANSFER WT AREMU SHOLA ABUJA NG,transfert
15-Apr-2021,'0GWTR,15-Apr-2021,"3,000.00",,"18,157.66","TRANSFER BETWEEN CUSTOMERS Via GTWorld REF:681976569000000030002104151724  from ASHAFA IBRAHIM ABDULLAHI  to  OGWUCHE, GRACE",SAVINGS ACCOUNT,GT_Bank,./static/raw/MR_IBRAHIM_ASHAFA_STATEMENT.pdf,TRANSFER BETWEEN CUSTOMERS Via GTWorld REF from ASHAFA IBRAHIM ABDULLAHI to OGWUCHE GRACE,TRANSFER BETWEEN CUSTOMERS Via GTWorld REF from ASHAFA IBRAHIM ABDULLAHI to OGWUCHE GRACE,transfert
15-Apr-2021,'0,15-Apr-2021,50.00,,"18,107.66",STAMP DUTY CHARGE 15042021 STAMP DUTY CHARGE - 15/04/2021,SAVINGS ACCOUNT,GT_Bank,./static/raw/MR_IBRAHIM_ASHAFA_STATEMENT.pdf,STAMP DUTY CHARGE STAMP DUTY CHARGE,STAMP DUTY CHARGE STAMP DUTY CHARGE,bank_charges
16-Apr-2021,'0GAPS,16-Apr-2021,,"27,075.00","45,182.66",TRANSFER BETWEEN CUSTOMERS via GAPS com on Ramia I 1.9M sales 111528766 0 from NETCONSTRUCT NIGERIA LIMITED to ASHAFA IBRAHIM ABDULLAHI REF: 0005628626111528766000000,SAVINGS ACCOUNT,GT_Bank,./static/raw/MR_IBRAHIM_ASHAFA_STATEMENT.pdf,TRANSFER BETWEEN CUSTOMERS via GAPS com on Ramia I M sales from NETCONSTRUCT NIGERIA LIMITED to ASHAFA IBRAHIM ABDULLAHI REF,TRANSFER BETWEEN CUSTOMERS via GAPS com on RamiaM sales from NETCONSTRUCT NIGERIA LIMITED to ASHAFA IBRAHIM ABDULLAHI REF,transfert
16-Apr-2021,'0GAPS,16-Apr-2021,,"27,363.80","72,546.46",TRANSFER BETWEEN CUSTOMERS via GAPS com on Ekene Nna 1M sales 111528771 0 from NETCONSTRUCT NIGERIA LIMITED to ASHAFA IBRAHIM ABDULLAHI REF: 0005628626111528771000000,SAVINGS ACCOUNT,GT_Bank,./static/raw/MR_IBRAHIM_ASHAFA_STATEMENT.pdf,TRANSFER BETWEEN CUSTOMERS via GAPS com on Ekene Nna M sales from NETCONSTRUCT NIGERIA LIMITED to ASHAFA IBRAHIM ABDULLAHI REF,TRANSFER BETWEEN CUSTOMERS via GAPS com on Ekene Nnasales from NETCONSTRUCT NIGERIA LIMITED to ASHAFA IBRAHIM ABDULLAHI REF,transfert
16-Apr-2021,'0GWTR,16-Apr-2021,"20,000.00",,"52,546.46","TRANSFER BETWEEN CUSTOMERS Via GTWorld REF:681976569000000200002104160937  from ASHAFA IBRAHIM ABDULLAHI  to  SALAMI, ABUBAKAR",SAVINGS ACCOUNT,GT_Bank,./static/raw/MR_IBRAHIM_ASHAFA_STATEMENT.pdf,TRANSFER BETWEEN CUSTOMERS Via GTWorld REF from ASHAFA IBRAHIM ABDULLAHI to SALAMI ABUBAKAR,TRANSFER BETWEEN CUSTOMERS Via GTWorld REF from ASHAFA IBRAHIM ABDULLAHI to SALAMI ABUBAKAR,transfert
16-Apr-2021,'0USAT,16-Apr-2021,700.00,,"51,846.46",Airtime Purchase GTWORLD- 101CT0000000002519275095-2348030549818,SAVINGS ACCOUNT,GT_Bank,./static/raw/MR_IBRAHIM_ASHAFA_STATEMENT.pdf,Airtime Purchase GTWORLD CT,Airtime Purchase GTWORLD CT,utility
16-Apr-2021,'0USAT,16-Apr-2021,700.00,,"51,146.46",Airtime Purchase GTWORLD- 101CT0000000002519276544-2348038673032,SAVINGS ACCOUNT,GT_Bank,./static/raw/MR_IBRAHIM_ASHAFA_STATEMENT.pdf,Airtime Purchase GTWORLD CT,Airtime Purchase GTWORLD CT,utility
16-Apr-2021,'0NIPG,16-Apr-2021,"2,000.00",,"49,146.46",NIBSS Instant Payment Outward 000013210416111749000089328488 via GTWORLD  TO UMAR AMINA MOHAMMED /10.75/REF:GW6819765690000000200021041611  f,SAVINGS ACCOUNT,GT_Bank,./static/raw/MR_IBRAHIM_ASHAFA_STATEMENT.pdf,NIBSS Instant Payment Outward via GTWORLD TO UMAR AMINA MOHAMMED REF GW f,NIBSS Instant Payment Outward via GTWORLD TO UMAR AMINA MOHAMMED REF GW,transfert
16-Apr-2021,'0NIPG,16-Apr-2021,10.00,,"49,136.46",COMMISSION 000013210416111749000089328488 NIP TRANSFER COMMISSION FOR000013210416111749000089328488 via GTWORLD  TO UMAR AMINA MOHAMMED ReF:GW681976569000000020002104161115,SAVINGS ACCOUNT,GT_Bank,./static/raw/MR_IBRAHIM_ASHAFA_STATEMENT.pdf,COMMISSION NIP TRANSFER COMMISSION FOR via GTWORLD TO UMAR AMINA MOHAMMED ReF GW,COMMISSION NIP TRANSFER COMMISSION FOR via GTWORLD TO UMAR AMINA MOHAMMED ReF GW,commission
16-Apr-2021,'0NIPG,16-Apr-2021,.75,,"49,135.71",VALUE ADDED TAX 000013210416111749000089328488 VAT ON NIP TRANSFER FOR 000013210416111749000089328488 via GTWORLD  TO UMAR AMINA MOHAMMED ReF:GW681976569000000020002104161115,SAVINGS ACCOUNT,GT_Bank,./static/raw/MR_IBRAHIM_ASHAFA_STATEMENT.pdf,VALUE ADDED TAX VAT ON NIP TRANSFER FOR via GTWORLD TO UMAR AMINA MOHAMMED ReF GW,VALUE ADDED TAX VAT ON NIP TRANSFER FOR via GTWORLD TO UMAR AMINA MOHAMMED ReF GW,tax
17-Apr-2021,'99994355749999,17-Apr-2021,"9,800.00",,"39,335.71",POS/WEB PURCHASE TRANSACTION  -435574- - 675067-Next Cash And Carry    C           F  NG,SAVINGS ACCOUNT,GT_Bank,./static/raw/MR_IBRAHIM_ASHAFA_STATEMENT.pdf,POS WEB PURCHASE TRANSACTION Next Cash And Carry C F NG,POS WEB PURCHASE TRANSACTION Next Cash And CarryF NG,others
17-Apr-2021,'99990071119999,17-Apr-2021,"9,200.00",,"30,135.71",FUNDS TRANSFER  -007111- -170271-T007111 2TGT1393       LA           LANG,SAVINGS ACCOUNT,GT_Bank,./static/raw/MR_IBRAHIM_ASHAFA_STATEMENT.pdf,FUNDS TRANSFER T TGT LA LANG,FUNDS TRANSFERTGT LA LANG,utility
17-Apr-2021,'0USAT,17-Apr-2021,"1,000.00",,"29,135.71",Airtime Purchase GTWORLD_QL- 101CT0000000002522859896-2348038673032,SAVINGS ACCOUNT,GT_Bank,./static/raw/MR_IBRAHIM_ASHAFA_STATEMENT.pdf,Airtime Purchase GTWORLD_QL CT,Airtime Purchase GTWORLDQL CT,utility
17-Apr-2021,'0NIPG,17-Apr-2021,"5,000.00",,"24,135.71",NIBSS Instant Payment Outward 000013210417190034000091621579 via GTWORLD  TO YUSUF HASSAN /10.75/REF:GW6819765690000000500021041718  f,SAVINGS ACCOUNT,GT_Bank,./static/raw/MR_IBRAHIM_ASHAFA_STATEMENT.pdf,NIBSS Instant Payment Outward via GTWORLD TO YUSUF HASSAN REF GW f,NIBSS Instant Payment Outward via GTWORLD TO YUSUF HASSAN REF GW,transfert
17-Apr-2021,'0NIPG,17-Apr-2021,10.00,,"24,125.71",COMMISSION 000013210417190034000091621579 NIP TRANSFER COMMISSION FOR 000013210417190034000091621579 via GTWORLD  TO YUSUF HASSAN ReF:GW681976569000000050002104171858,SAVINGS ACCOUNT,GT_Bank,./static/raw/MR_IBRAHIM_ASHAFA_STATEMENT.pdf,COMMISSION NIP TRANSFER COMMISSION FOR via GTWORLD TO YUSUF HASSAN ReF GW,COMMISSION NIP TRANSFER COMMISSION FOR via GTWORLD TO YUSUF HASSAN ReF GW,commission
17-Apr-2021,'0NIPG,17-Apr-2021,.75,,"24,124.96",VALUE ADDED TAX 000013210417190034000091621579 VAT ON NIP TRANSFER FOR 000013210417190034000091621579 via GTWORLD  TO YUSUF HASSAN ReF:GW681976569000000050002104171858,SAVINGS ACCOUNT,GT_Bank,./static/raw/MR_IBRAHIM_ASHAFA_STATEMENT.pdf,VALUE ADDED TAX VAT ON NIP TRANSFER FOR via GTWORLD TO YUSUF HASSAN ReF GW,VALUE ADDED TAX VAT ON NIP TRANSFER FOR via GTWORLD TO YUSUF HASSAN ReF GW,tax
17-Apr-2021,'0NIPG,17-Apr-2021,"2,000.00",,"22,124.96",NIBSS Instant Payment Outward 000013210417190216000091623940 via GTWORLD  TO HASSAN ABDULLAHI /10.75/REF:GW6819765690000000200021041719  f,SAVINGS ACCOUNT,GT_Bank,./static/raw/MR_IBRAHIM_ASHAFA_STATEMENT.pdf,NIBSS Instant Payment Outward via GTWORLD TO HASSAN ABDULLAHI REF GW f,NIBSS Instant Payment Outward via GTWORLD TO HASSAN ABDULLAHI REF GW,transfert
17-Apr-2021,'0NIPG,17-Apr-2021,10.00,,"22,114.96",COMMISSION 000013210417190216000091623940 NIP TRANSFER COMMISSION FOR 000013210417190216000091623940 via GTWORLD  TO HASSAN ABDULLAHIReF:GW681976569000000020002104171900,SAVINGS ACCOUNT,GT_Bank,./static/raw/MR_IBRAHIM_ASHAFA_STATEMENT.pdf,COMMISSION NIP TRANSFER COMMISSION FOR via GTWORLD TO HASSAN ABDULLAHIReF GW,COMMISSION NIP TRANSFER COMMISSION FOR via GTWORLD TO HASSAN ABDULLAHIReF GW,commission
17-Apr-2021,'0NIPG,17-Apr-2021,.75,,"22,114.21",VALUE ADDED TAX000013210417190216000091623940 VAT ON NIPTRANSFER FOR000013210417190216000091623940 viaGTWORLD  TO HASSAN ABDULLAHIReF:GW681976569000000020002104171900,SAVINGS ACCOUNT,GT_Bank,./static/raw/MR_IBRAHIM_ASHAFA_STATEMENT.pdf,VALUE ADDED TAX VAT ON NIPTRANSFER FOR viaGTWORLD TO HASSAN ABDULLAHIReF GW,VALUE ADDED TAX VAT ON NIPTRANSFER FOR via GTWORLD TO HASSAN ABDULLAHIReF GW,tax
19-Apr-2021,'0USAT,19-Apr-2021,"1,000.00",,"21,114.21",Airtime Purchase GTWORLD_QL-101CT0000000002526139944-2348038673032,SAVINGS ACCOUNT,GT_Bank,./static/raw/MR_IBRAHIM_ASHAFA_STATEMENT.pdf,Airtime Purchase GTWORLD_QL CT,Airtime Purchase GTWORLDQL CT,utility
19-Apr-2021,'99998729789999,19-Apr-2021,100.00,,"21,014.21",PURCHASE/TRANSFER COMMISSION  -872978- -123505-WT|BASHIR AHMAD ABDULLAHIABUJANG,SAVINGS ACCOUNT,GT_Bank,./static/raw/MR_IBRAHIM_ASHAFA_STATEMENT.pdf,PURCHASE TRANSFER COMMISSION WT BASHIR AHMAD ABDULLAHIABUJANG,PURCHASE TRANSFER COMMISSION WT BASHIR AHMAD ABDULLAHIABUJANG,transfert
19-Apr-2021,'99998729789999,19-Apr-2021,"10,000.00",,"11,014.21",ATM/POS ACOUNT TO ACCOUNT TRANSFER  -872978- -123505-WT|BASHIR AHMADABDULLAHIABUJANG,SAVINGS ACCOUNT,GT_Bank,./static/raw/MR_IBRAHIM_ASHAFA_STATEMENT.pdf,ATM POS ACOUNT TO ACCOUNT TRANSFER WT BASHIR AHMADABDULLAHIABUJANG,ATM POS ACOUNT TO ACCOUNT TRANSFER WT BASHIR AHMADABDULLAHIABUJANG,transfert
20-Apr-2021,'0USAT,20-Apr-2021,"1,000.00",,"10,014.21",Airtime Purchase GTWORLD_QL-101CT0000000002530184425-2348038673032,SAVINGS ACCOUNT,GT_Bank,./static/raw/MR_IBRAHIM_ASHAFA_STATEMENT.pdf,Airtime Purchase GTWORLD_QL CT,Airtime Purchase GTWORLDQL CT,utility
22-Apr-2021,'0USAT,22-Apr-2021,"1,000.00",,"9,014.21",Airtime Purchase GTWORLD_QL-101CT0000000002535387670-2348038673032,SAVINGS ACCOUNT,GT_Bank,./static/raw/MR_IBRAHIM_ASHAFA_STATEMENT.pdf,Airtime Purchase GTWORLD_QL CT,Airtime Purchase GTWORLDQL CT,utility
23-Apr-2021,'0GAPS,23-Apr-2021,,"14,250.00","23,264.21",TRANSFER BETWEEN CUSTOMERS via GAPScom on Ige O 1M sales.. 111815750 0 fromNETCONSTRUCT NIGERIA LIMITED to ASHAFAIBRAHIM ABDULLAHIREF: 0005628626111815750000000,SAVINGS ACCOUNT,GT_Bank,./static/raw/MR_IBRAHIM_ASHAFA_STATEMENT.pdf,TRANSFER BETWEEN CUSTOMERS via GAPScom on Ige O M sales fromNETCONSTRUCT NIGERIA LIMITED to ASHAFAIBRAHIM ABDULLAHIREF,TRANSFER BETWEEN CUSTOMERS via GAPScom on IgeM sales from NETCONSTRUCT NIGERIA LIMITED to ASHAFAIBRAHIM ABDULLAHIREF,transfert
23-Apr-2021,'0NIPG,23-Apr-2021,"5,000.00",,"18,264.21",NIBSS Instant Payment Outward000013210423132244000099567848 viaGTWORLD  TO AZUATALAM RHODAOLUWAFUNMILOLA/10.75/REF:GW6819765690000000500021042313  f,SAVINGS ACCOUNT,GT_Bank,./static/raw/MR_IBRAHIM_ASHAFA_STATEMENT.pdf,NIBSS Instant Payment Outward viaGTWORLD TO AZUATALAM RHODAOLUWAFUNMILOLA REF GW f,NIBSS Instant Payment Outward via GTWORLD TO AZUATALAM RHODAOLUWAFUNMILOLA REF GW,transfert
23-Apr-2021,'0NIPG,23-Apr-2021,10.00,,"18,254.21",COMMISSION 000013210423132244000099567848NIP TRANSFER COMMISSION FOR000013210423132244000099567848 viaGTWORLD  TO AZUATALAM RHODAOLUWAFUNMILOLAReF:GW681976569000000050002104231321,SAVINGS ACCOUNT,GT_Bank,./static/raw/MR_IBRAHIM_ASHAFA_STATEMENT.pdf,COMMISSION NIP TRANSFER COMMISSION FOR viaGTWORLD TO AZUATALAM RHODAOLUWAFUNMILOLAReF GW,COMMISSION NIP TRANSFER COMMISSION FOR via GTWORLD TO AZUATALAM RHODAOLUWAFUNMILOLAReF GW,commission
23-Apr-2021,'0NIPG,23-Apr-2021,.75,,"18,253.46",VALUE ADDED TAX000013210423132244000099567848 VAT ON NIPTRANSFER FOR000013210423132244000099567848 viaGTWORLD  TO AZUATALAM RHODAOLUWAFUNMILOLAReF:GW681976569000000050002104231321,SAVINGS ACCOUNT,GT_Bank,./static/raw/MR_IBRAHIM_ASHAFA_STATEMENT.pdf,VALUE ADDED TAX VAT ON NIPTRANSFER FOR viaGTWORLD TO AZUATALAM RHODAOLUWAFUNMILOLAReF GW,VALUE ADDED TAX VAT ON NIPTRANSFER FOR via GTWORLD TO AZUATALAM RHODAOLUWAFUNMILOLAReF GW,tax
24-Apr-2021,'0NIPT,24-Apr-2021,,"20,000.00","38,253.46",TRANSFER BETWEEN CUSTOMERS000004210424085211001135116234|USSD-NIP/ToASHAFAA./23480XXXX9995|2348038509995/1135116234||ABDULLAHI ASHAFAREF:000004210424085211001135116234,SAVINGS ACCOUNT,GT_Bank,./static/raw/MR_IBRAHIM_ASHAFA_STATEMENT.pdf,TRANSFER BETWEEN CUSTOMERS USSD NIP ToASHAFAA XXXX ABDULLAHI ASHAFAREF,TRANSFER BETWEEN CUSTOMERS USSD NIP ToASHAFAA XXXX ABDULLAHI ASHAFAREF,transfert
24-Apr-2021,'0GWTR,24-Apr-2021,"10,000.00",,"28,253.46","TRANSFER BETWEEN CUSTOMERS Via GTWorldREF:681976569000000100002104241206  fromASHAFA IBRAHIM ABDULLAHI  to  ADAM,ABDULLAHI",SAVINGS ACCOUNT,GT_Bank,./static/raw/MR_IBRAHIM_ASHAFA_STATEMENT.pdf,TRANSFER BETWEEN CUSTOMERS Via GTWorldREF fromASHAFA IBRAHIM ABDULLAHI to ADAM ABDULLAHI,TRANSFER BETWEEN CUSTOMERS Via GTWorldREF from ASHAFA IBRAHIM ABDULLAHI to ADAM ABDULLAHI,transfert
24-Apr-2021,'0USAT,24-Apr-2021,"1,000.00",,"27,253.46",Airtime Purchase GTWORLD_QL-101CT0000000002539689517-2348038673032,SAVINGS ACCOUNT,GT_Bank,./static/raw/MR_IBRAHIM_ASHAFA_STATEMENT.pdf,Airtime Purchase GTWORLD_QL CT,Airtime Purchase GTWORLDQL CT,utility
24-Apr-2021,'0NIPG,24-Apr-2021,"8,000.00",,"19,253.46",NIBSS Instant Payment Outward000013210424165948000101530802 viaGTWORLD  TO USMAN YAKUBU BABA/26.875/REF:GW6819765690000000800021042416f,SAVINGS ACCOUNT,GT_Bank,./static/raw/MR_IBRAHIM_ASHAFA_STATEMENT.pdf,NIBSS Instant Payment Outward viaGTWORLD TO USMAN YAKUBU BABA REF GW f,NIBSS Instant Payment Outward via GTWORLD TO USMAN YAKUBU BABA REF GW,transfert
24-Apr-2021,'0NIPG,24-Apr-2021,25.00,,"19,228.46",COMMISSION 000013210424165948000101530802NIP TRANSFER COMMISSION FOR000013210424165948000101530802 viaGTWORLD  TO USMAN YAKUBU BABAReF:GW681976569000000080002104241657,SAVINGS ACCOUNT,GT_Bank,./static/raw/MR_IBRAHIM_ASHAFA_STATEMENT.pdf,COMMISSION NIP TRANSFER COMMISSION FOR viaGTWORLD TO USMAN YAKUBU BABAReF GW,COMMISSION NIP TRANSFER COMMISSION FOR via GTWORLD TO USMAN YAKUBU BABAReF GW,commission
24-Apr-2021,'0NIPG,24-Apr-2021,1.87,,"19,226.59",VALUE ADDED TAX000013210424165948000101530802 VAT ON NIPTRANSFER FOR000013210424165948000101530802 viaGTWORLD  TO USMAN YAKUBU BABAReF:GW681976569000000080002104241657,SAVINGS ACCOUNT,GT_Bank,./static/raw/MR_IBRAHIM_ASHAFA_STATEMENT.pdf,VALUE ADDED TAX VAT ON NIPTRANSFER FOR viaGTWORLD TO USMAN YAKUBU BABAReF GW,VALUE ADDED TAX VAT ON NIPTRANSFER FOR via GTWORLD TO USMAN YAKUBU BABAReF GW,tax
24-Apr-2021,'99990076299999,24-Apr-2021,"5,100.00",,"14,126.59",FUNDS TRANSFER  -007629- -610644-T0076292TGT1393LALANG,SAVINGS ACCOUNT,GT_Bank,./static/raw/MR_IBRAHIM_ASHAFA_STATEMENT.pdf,FUNDS TRANSFER T TGT LALANG,FUNDS TRANSFERTGT LALANG,loan
24-Apr-2021,'0NIPG,24-Apr-2021,"4,000.00",,"10,126.59",NIBSS Instant Payment Outward000013210424190836000101755982 viaGTWORLD  TO JIBRIN BASIRAH USMAN/10.75/REF:GW6819765690000000400021042419  f,SAVINGS ACCOUNT,GT_Bank,./static/raw/MR_IBRAHIM_ASHAFA_STATEMENT.pdf,NIBSS Instant Payment Outward viaGTWORLD TO JIBRIN BASIRAH USMAN REF GW f,NIBSS Instant Payment Outward via GTWORLD TO JIBRIN BASIRAH USMAN REF GW,transfert
24-Apr-2021,'0NIPG,24-Apr-2021,10.00,,"10,116.59",COMMISSION 000013210424190836000101755982 NIP TRANSFER COMMISSION FOR 000013210424190836000101755982 via GTWORLD  TO JIBRIN BASIRAH USMAN ReF:GW681976569000000040002104241906,SAVINGS ACCOUNT,GT_Bank,./static/raw/MR_IBRAHIM_ASHAFA_STATEMENT.pdf,COMMISSION NIP TRANSFER COMMISSION FOR via GTWORLD TO JIBRIN BASIRAH USMAN ReF GW,COMMISSION NIP TRANSFER COMMISSION FOR via GTWORLD TO JIBRIN BASIRAH USMAN ReF GW,commission
24-Apr-2021,'0NIPG,24-Apr-2021,.75,,"10,115.84",VALUE ADDED TAX 000013210424190836000101755982 VAT ON NIP TRANSFER FOR 000013210424190836000101755982 via GTWORLD  TO JIBRIN BASIRAH USMAN ReF:GW681976569000000040002104241906,SAVINGS ACCOUNT,GT_Bank,./static/raw/MR_IBRAHIM_ASHAFA_STATEMENT.pdf,VALUE ADDED TAX VAT ON NIP TRANSFER FOR via GTWORLD TO JIBRIN BASIRAH USMAN ReF GW,VALUE ADDED TAX VAT ON NIP TRANSFER FOR via GTWORLD TO JIBRIN BASIRAH USMAN ReF GW,tax
24-Apr-2021,'0USAT,24-Apr-2021,900.00,,"9,215.84",Airtime Purchase GTWORLD_QL- 101CT0000000002540377895-2348035810634,SAVINGS ACCOUNT,GT_Bank,./static/raw/MR_IBRAHIM_ASHAFA_STATEMENT.pdf,Airtime Purchase GTWORLD_QL CT,Airtime Purchase GTWORLDQL CT,utility
25-Apr-2021,'0,24-Apr-2021,50.00,,"9,165.84",STAMP DUTY CHARGE 24042021 STAMP DUTY CHARGE - 24/04/2021,SAVINGS ACCOUNT,GT_Bank,./static/raw/MR_IBRAHIM_ASHAFA_STATEMENT.pdf,STAMP DUTY CHARGE STAMP DUTY CHARGE,STAMP DUTY CHARGE STAMP DUTY CHARGE,bank_charges
25-Apr-2021,'240,24-Apr-2021,376.00,,"8,789.84",SMS ALERT CHARGE FOR 26MAR2021- 22APR2021,SAVINGS ACCOUNT,GT_Bank,./static/raw/MR_IBRAHIM_ASHAFA_STATEMENT.pdf,SMS ALERT CHARGE FOR MAR APR,SMS ALERT CHARGE FOR MAR APR,loan
25-Apr-2021,'250,24-Apr-2021,28.20,,"8,761.64",VAT ON SMS ALERT CHARGE FOR 26MAR2021- 22APR2021,SAVINGS ACCOUNT,GT_Bank,./static/raw/MR_IBRAHIM_ASHAFA_STATEMENT.pdf,VAT ON SMS ALERT CHARGE FOR MAR APR,VAT ON SMS ALERT CHARGE FOR MAR APR,commission
25-Apr-2021,'0USAT,25-Apr-2021,600.00,,"8,161.64",Airtime Purchase GTWORLD_QL- 101CT0000000002542109674-2348038673032,SAVINGS ACCOUNT,GT_Bank,./static/raw/MR_IBRAHIM_ASHAFA_STATEMENT.pdf,Airtime Purchase GTWORLD_QL CT,Airtime Purchase GTWORLDQL CT,utility
26-Apr-2021,'0NIPT,26-Apr-2021,,"120,000.00","128,161.64",TRANSFER BETWEEN CUSTOMERS 000026210426115050000004055981|NIP/TRF IFO ASHAFA IBRAHIM ABDULLAHI BO IBRAHIM AS|STAJJNG21042606539849||IBRAHIM ASHAFA REF:000026210426115050000004055981,SAVINGS ACCOUNT,GT_Bank,./static/raw/MR_IBRAHIM_ASHAFA_STATEMENT.pdf,TRANSFER BETWEEN CUSTOMERS NIP TRF IFO ASHAFA IBRAHIM ABDULLAHI BO IBRAHIM AS STAJJNG IBRAHIM ASHAFA REF,TRANSFER BETWEEN CUSTOMERS NIP TRF IFO ASHAFA IBRAHIM ABDULLAHI BO IBRAHIM AS STAJJNG IBRAHIM ASHAFA REF,transfert
26-Apr-2021,'0GWTR,26-Apr-2021,"90,000.00",,"38,161.64","TRANSFER BETWEEN CUSTOMERS Via GTWorld REF:681976569000000900002104261157  from ASHAFA IBRAHIM ABDULLAHI  to  ADAM, ABDULLAHI",SAVINGS ACCOUNT,GT_Bank,./static/raw/MR_IBRAHIM_ASHAFA_STATEMENT.pdf,TRANSFER BETWEEN CUSTOMERS Via GTWorld REF from ASHAFA IBRAHIM ABDULLAHI to ADAM ABDULLAHI,TRANSFER BETWEEN CUSTOMERS Via GTWorld REF from ASHAFA IBRAHIM ABDULLAHI to ADAM ABDULLAHI,transfert
26-Apr-2021,'0NIPG,26-Apr-2021,"10,000.00",,"28,161.64",NIBSS Instant Payment Outward 000013210426120239000103595981 via GTWORLD  TO JIBRIN BASIRAH USMAN /26.875/REF:GW6819765690000001000021042612 f,SAVINGS ACCOUNT,GT_Bank,./static/raw/MR_IBRAHIM_ASHAFA_STATEMENT.pdf,NIBSS Instant Payment Outward via GTWORLD TO JIBRIN BASIRAH USMAN REF GW f,NIBSS Instant Payment Outward via GTWORLD TO JIBRIN BASIRAH USMAN REF GW,transfert
26-Apr-2021,'0NIPG,26-Apr-2021,25.00,,"28,136.64",COMMISSION 000013210426120239000103595981NIP TRANSFER COMMISSION FOR 000013210426120239000103595981 via GTWORLD  TO JIBRIN BASIRAH USMAN ReF:GW681976569000000100002104261201,SAVINGS ACCOUNT,GT_Bank,./static/raw/MR_IBRAHIM_ASHAFA_STATEMENT.pdf,COMMISSION NIP TRANSFER COMMISSION FOR via GTWORLD TO JIBRIN BASIRAH USMAN ReF GW,COMMISSION NIP TRANSFER COMMISSION FOR via GTWORLD TO JIBRIN BASIRAH USMAN ReF GW,commission
26-Apr-2021,'0NIPG,26-Apr-2021,1.87,,"28,134.77",VALUE ADDED TAX 000013210426120239000103595981 VAT ON NIP TRANSFER FOR 000013210426120239000103595981 via GTWORLD  TO JIBRIN BASIRAH USMAN ReF:GW681976569000000100002104261201,SAVINGS ACCOUNT,GT_Bank,./static/raw/MR_IBRAHIM_ASHAFA_STATEMENT.pdf,VALUE ADDED TAX VAT ON NIP TRANSFER FOR via GTWORLD TO JIBRIN BASIRAH USMAN ReF GW,VALUE ADDED TAX VAT ON NIP TRANSFER FOR via GTWORLD TO JIBRIN BASIRAH USMAN ReF GW,tax
26-Apr-2021,'0NIPG,26-Apr-2021,"10,000.00",,"18,134.77",NIBSS Instant Payment Outward 000013210426120510000103600458 via GTWORLD  TO HALIMA TANKO ABUBAKAR /26.875/REF:GW6819765690000001000021042612 f,SAVINGS ACCOUNT,GT_Bank,./static/raw/MR_IBRAHIM_ASHAFA_STATEMENT.pdf,NIBSS Instant Payment Outward via GTWORLD TO HALIMA TANKO ABUBAKAR REF GW f,NIBSS Instant Payment Outward via GTWORLD TO HALIMA TANKO ABUBAKAR REF GW,transfert
26-Apr-2021,'0NIPG,26-Apr-2021,25.00,,"18,109.77",COMMISSION 000013210426120510000103600458 NIP TRANSFER COMMISSION FOR 000013210426120510000103600458 via GTWORLD  TO HALIMA TANKO ABUBAKAR ReF:GW681976569000000100002104261203,SAVINGS ACCOUNT,GT_Bank,./static/raw/MR_IBRAHIM_ASHAFA_STATEMENT.pdf,COMMISSION NIP TRANSFER COMMISSION FOR via GTWORLD TO HALIMA TANKO ABUBAKAR ReF GW,COMMISSION NIP TRANSFER COMMISSION FOR via GTWORLD TO HALIMA TANKO ABUBAKAR ReF GW,commission
26-Apr-2021,'0NIPG,26-Apr-2021,1.87,,"18,107.90",VALUE ADDED TAX 000013210426120510000103600458 VAT ON NIP TRANSFER FOR 000013210426120510000103600458 via GTWORLD  TO HALIMA TANKO ABUBAKAR ReF:GW681976569000000100002104261203,SAVINGS ACCOUNT,GT_Bank,./static/raw/MR_IBRAHIM_ASHAFA_STATEMENT.pdf,VALUE ADDED TAX VAT ON NIP TRANSFER FOR via GTWORLD TO HALIMA TANKO ABUBAKAR ReF GW,VALUE ADDED TAX VAT ON NIP TRANSFER FOR via GTWORLD TO HALIMA TANKO ABUBAKAR ReF GW,tax
26-Apr-2021,'0USAT,26-Apr-2021,"1,000.00",,"17,107.90",Airtime Purchase GTWORLD_QL- 101CT0000000002544066528-2348038673032,SAVINGS ACCOUNT,GT_Bank,./static/raw/MR_IBRAHIM_ASHAFA_STATEMENT.pdf,Airtime Purchase GTWORLD_QL CT,Airtime Purchase GTWORLDQL CT,utility
26-Apr-2021,'0,26-Apr-2021,50.00,,"17,057.90",STAMP DUTY CHARGE 26042021 STAMP DUTY CHARGE - 26/04/2021,SAVINGS ACCOUNT,GT_Bank,./static/raw/MR_IBRAHIM_ASHAFA_STATEMENT.pdf,STAMP DUTY CHARGE STAMP DUTY CHARGE,STAMP DUTY CHARGE STAMP DUTY CHARGE,bank_charges
27-Apr-2021,'99996903609999,27-Apr-2021,"7,000.00",,"10,057.90",POS/WEB PURCHASE TRANSACTION  -690360- - 264967-DIATO OIL LIMITED      FC           FCNG,SAVINGS ACCOUNT,GT_Bank,./static/raw/MR_IBRAHIM_ASHAFA_STATEMENT.pdf,POS WEB PURCHASE TRANSACTION DIATO OIL LIMITED FC FCNG,POS WEB PURCHASE TRANSACTION DIATO OIL LIMITED FC FCNG,utility
27-Apr-2021,'0NIPG,27-Apr-2021,"2,000.00",,"8,057.90",NIBSS Instant Payment Outward 000013210427153421000105607837 via GTWORLD  TO MADAKI ALI /10.75/REF:GW6819765690000000200021042715  f,SAVINGS ACCOUNT,GT_Bank,./static/raw/MR_IBRAHIM_ASHAFA_STATEMENT.pdf,NIBSS Instant Payment Outward via GTWORLD TO MADAKI ALI REF GW f,NIBSS Instant Payment Outward via GTWORLD TO MADAKI ALI REF GW,transfert
27-Apr-2021,'0NIPG,27-Apr-2021,10.00,,"8,047.90",COMMISSION 000013210427153421000105607837 NIP TRANSFER COMMISSION FOR000013210427153421000105607837 via GTWORLD  TO MADAKI ALI ReF:GW681976569000000020002104271532,SAVINGS ACCOUNT,GT_Bank,./static/raw/MR_IBRAHIM_ASHAFA_STATEMENT.pdf,COMMISSION NIP TRANSFER COMMISSION FOR via GTWORLD TO MADAKI ALI ReF GW,COMMISSION NIP TRANSFER COMMISSION FOR via GTWORLD TO MADAKI ALI ReF GW,commission
27-Apr-2021,'0NIPG,27-Apr-2021,.75,,"8,047.15",VALUE ADDED TAX 000013210427153421000105607837 VAT ON NIP TRANSFER FOR 000013210427153421000105607837 via GTWORLD  TO MADAKI ALI ReF:GW681976569000000020002104271532,SAVINGS ACCOUNT,GT_Bank,./static/raw/MR_IBRAHIM_ASHAFA_STATEMENT.pdf,VALUE ADDED TAX VAT ON NIP TRANSFER FOR via GTWORLD TO MADAKI ALI ReF GW,VALUE ADDED TAX VAT ON NIP TRANSFER FOR via GTWORLD TO MADAKI ALI ReF GW,tax
27-Apr-2021,'0GWTR,27-Apr-2021,"3,750.00",,"4,297.15","TRANSFER BETWEEN CUSTOMERS Via GTWorld REF:681976569000000037502104271553  from ASHAFA IBRAHIM ABDULLAHI  to  UMAR , USMAN ABUBAKAR",SAVINGS ACCOUNT,GT_Bank,./static/raw/MR_IBRAHIM_ASHAFA_STATEMENT.pdf,TRANSFER BETWEEN CUSTOMERS Via GTWorld REF from ASHAFA IBRAHIM ABDULLAHI to UMAR USMAN ABUBAKAR,TRANSFER BETWEEN CUSTOMERS Via GTWorld REF from ASHAFA IBRAHIM ABDULLAHI to UMAR USMAN ABUBAKAR,transfert
27-Apr-2021,'99992371339999,27-Apr-2021,35.00,,"4,262.15",ATM WITHDRAWAL COMMISSION  -237133- - 229998-000000000000932 Boling Abuja          NG,SAVINGS ACCOUNT,GT_Bank,./static/raw/MR_IBRAHIM_ASHAFA_STATEMENT.pdf,ATM WITHDRAWAL COMMISSION Boling Abuja NG,ATM WITHDRAWAL COMMISSION Boling Abuja NG,utility
27-Apr-2021,'99992371339999,27-Apr-2021,"4,000.00",,262.15,CASH WITHDRAWAL FROM OTHER ATM  - 237133- -229998-000000000000932 Boling Abuja NG,SAVINGS ACCOUNT,GT_Bank,./static/raw/MR_IBRAHIM_ASHAFA_STATEMENT.pdf,CASH WITHDRAWAL FROM OTHER ATM Boling Abuja NG,CASH WITHDRAWAL FROM OTHER ATM Boling Abuja NG,cash
28-Apr-2021,'0USAT,28-Apr-2021,200.00,,62.15,Airtime Purchase GTWORLD_QL- 101CT0000000002548659468-2348038673032,SAVINGS ACCOUNT,GT_Bank,./static/raw/MR_IBRAHIM_ASHAFA_STATEMENT.pdf,Airtime Purchase GTWORLD_QL CT,Airtime Purchase GTWORLDQL CT,utility
30-Apr-2021,'41200012076,30-Apr-2021,"26,529.45",,"-26,467.30",MATURED LOAN INSTALLMENT,SAVINGS ACCOUNT,GT_Bank,./static/raw/MR_IBRAHIM_ASHAFA_STATEMENT.pdf,MATURED LOAN INSTALLMENT,MATURED LOAN INSTALLMENT,loan
30-Apr-2021,'0,30-Apr-2021,20.30,,"-26,487.60",INTEREST CAPITALISED,SAVINGS ACCOUNT,GT_Bank,./static/raw/MR_IBRAHIM_ASHAFA_STATEMENT.pdf,INTEREST CAPITALISED,INTEREST CAPITALISED,loan
03-May-2021,'0NIPT,03-May-2021,,"110,004.95","83,517.35",TRANSFER BETWEEN CUSTOMERS 000004210503102502200099267782|TUD IBG/UTO/NetC Apr Sal Ashafa|200099267782||NET CONSTRUCT NIGERIA LIMITED REF:000004210503102502200099267782,SAVINGS ACCOUNT,GT_Bank,./static/raw/MR_IBRAHIM_ASHAFA_STATEMENT.pdf,TRANSFER BETWEEN CUSTOMERS TUD IBG UTO NetC Apr Sal Ashafa NET CONSTRUCT NIGERIA LIMITED REF,TRANSFER BETWEEN CUSTOMERS TUD IBG UTO NetC Apr Sal Ashafa NET CONSTRUCT NIGERIA LIMITED REF,transfert
03-May-2021,'0GWTR,03-May-2021,"40,000.00",,"43,517.35",TRANSFER BETWEEN CUSTOMERS Via GTWorld REF:681976569000000400002105031354  from ASHAFA IBRAHIM ABDULLAHI  to  SULEIMAN ALIYU,SAVINGS ACCOUNT,GT_Bank,./static/raw/MR_IBRAHIM_ASHAFA_STATEMENT.pdf,TRANSFER BETWEEN CUSTOMERS Via GTWorld REF from ASHAFA IBRAHIM ABDULLAHI to SULEIMAN ALIYU,TRANSFER BETWEEN CUSTOMERS Via GTWorld REF from ASHAFA IBRAHIM ABDULLAHI to SULEIMAN ALIYU,transfert
03-May-2021,'0NIPG,03-May-2021,"5,000.00",,"38,517.35",NIBSS Instant Payment Outward 000013210503135547000114957611 via GTWORLD  TO ISMAILA ATTEH AUDU /10.75/REF:GW6819765690000000500021050313  f,SAVINGS ACCOUNT,GT_Bank,./static/raw/MR_IBRAHIM_ASHAFA_STATEMENT.pdf,NIBSS Instant Payment Outward via GTWORLD TO ISMAILA ATTEH AUDU REF GW f,NIBSS Instant Payment Outward via GTWORLD TO ISMAILA ATTEH AUDU REF GW,transfert
03-May-2021,'0NIPG,03-May-2021,10.00,,"38,507.35",COMMISSION 000013210503135547000114957611 NIP TRANSFER COMMISSION FOR000013210503135547000114957611 viaGTWORLD  TO ISMAILA ATTEH AUDUReF:GW681976569000000050002105031356,SAVINGS ACCOUNT,GT_Bank,./static/raw/MR_IBRAHIM_ASHAFA_STATEMENT.pdf,COMMISSION NIP TRANSFER COMMISSION FOR viaGTWORLD TO ISMAILA ATTEH AUDUReF GW,COMMISSION NIP TRANSFER COMMISSION FOR via GTWORLD TO ISMAILA ATTEH AUDUReF GW,commission
03-May-2021,'0NIPG,03-May-2021,.75,,"38,506.60",VALUE ADDED TAX000013210503135547000114957611 VAT ON NIPTRANSFER FOR000013210503135547000114957611 viaGTWORLD  TO ISMAILA ATTEH AUDUReF:GW681976569000000050002105031356,SAVINGS ACCOUNT,GT_Bank,./static/raw/MR_IBRAHIM_ASHAFA_STATEMENT.pdf,VALUE ADDED TAX VAT ON NIPTRANSFER FOR viaGTWORLD TO ISMAILA ATTEH AUDUReF GW,VALUE ADDED TAX VAT ON NIPTRANSFER FOR via GTWORLD TO ISMAILA ATTEH AUDUReF GW,tax
03-May-2021,'0NIPG,03-May-2021,"10,000.00",,"28,506.60",NIBSS Instant Payment Outward000013210503135728000114960909 viaGTWORLD  TO HAUWA . MUSA/26.875/REF:GW6819765690000001000021050313f,SAVINGS ACCOUNT,GT_Bank,./static/raw/MR_IBRAHIM_ASHAFA_STATEMENT.pdf,NIBSS Instant Payment Outward viaGTWORLD TO HAUWA MUSA REF GW f,NIBSS Instant Payment Outward via GTWORLD TO HAUWA MUSA REF GW,transfert
03-May-2021,'0NIPG,03-May-2021,25.00,,"28,481.60",COMMISSION 000013210503135728000114960909NIP TRANSFER COMMISSION FOR000013210503135728000114960909 viaGTWORLD  TO HAUWA . MUSAReF:GW681976569000000100002105031358,SAVINGS ACCOUNT,GT_Bank,./static/raw/MR_IBRAHIM_ASHAFA_STATEMENT.pdf,COMMISSION NIP TRANSFER COMMISSION FOR viaGTWORLD TO HAUWA MUSAReF GW,COMMISSION NIP TRANSFER COMMISSION FOR via GTWORLD TO HAUWA MUSAReF GW,commission
03-May-2021,'0NIPG,03-May-2021,1.87,,"28,479.73",VALUE ADDED TAX000013210503135728000114960909 VAT ON NIPTRANSFER FOR000013210503135728000114960909 viaGTWORLD  TO HAUWA . MUSAReF:GW681976569000000100002105031358,SAVINGS ACCOUNT,GT_Bank,./static/raw/MR_IBRAHIM_ASHAFA_STATEMENT.pdf,VALUE ADDED TAX VAT ON NIPTRANSFER FOR viaGTWORLD TO HAUWA MUSAReF GW,VALUE ADDED TAX VAT ON NIPTRANSFER FOR via GTWORLD TO HAUWA MUSAReF GW,tax
03-May-2021,'0USAT,03-May-2021,700.00,,"27,779.73",Airtime Purchase GTWORLD_QL-101CT0000000002562565087-2347062337947,SAVINGS ACCOUNT,GT_Bank,./static/raw/MR_IBRAHIM_ASHAFA_STATEMENT.pdf,Airtime Purchase GTWORLD_QL CT,Airtime Purchase GTWORLDQL CT,utility
03-May-2021,'0USAT,03-May-2021,700.00,,"27,079.73",Airtime Purchase GTWORLD_QL-101CT0000000002562567562-2347062337947,SAVINGS ACCOUNT,GT_Bank,./static/raw/MR_IBRAHIM_ASHAFA_STATEMENT.pdf,Airtime Purchase GTWORLD_QL CT,Airtime Purchase GTWORLDQL CT,utility
04-May-2021,'0,03-May-2021,50.00,,"27,029.73",STAMP DUTY CHARGE 03052021 STAMP DUTYCHARGE - 03/05/2021,SAVINGS ACCOUNT,GT_Bank,./static/raw/MR_IBRAHIM_ASHAFA_STATEMENT.pdf,STAMP DUTY CHARGE STAMP DUTYCHARGE,STAMP DUTY CHARGE STAMP DUTYCHARGE,bank_charges
04-May-2021,'99999458819999,04-May-2021,"7,000.00",,"20,029.73",POS/WEB PURCHASE TRANSACTION  -945881- -306057-INFINITY TRUST POS SFCFCNG,SAVINGS ACCOUNT,GT_Bank,./static/raw/MR_IBRAHIM_ASHAFA_STATEMENT.pdf,POS WEB PURCHASE TRANSACTION INFINITY TRUST POS SFCFCNG,POS WEB PURCHASE TRANSACTION INFINITY TRUST POS SFCFCNG,cash
04-May-2021,'0GAPS,04-May-2021,,"313,500.00","333,529.73",TRANSFER BETWEEN CUSTOMERS via GAPScom on Jibrin M 22M sales 112622210 0 fromNETCONSTRUCT NIGERIA LIMITED to ASHAFAIBRAHIM ABDULLAHIREF: 0005628626112622210000000,SAVINGS ACCOUNT,GT_Bank,./static/raw/MR_IBRAHIM_ASHAFA_STATEMENT.pdf,TRANSFER BETWEEN CUSTOMERS via GAPScom on Jibrin M M sales fromNETCONSTRUCT NIGERIA LIMITED to ASHAFAIBRAHIM ABDULLAHIREF,TRANSFER BETWEEN CUSTOMERS via GAPScom on JibrinM sales from NETCONSTRUCT NIGERIA LIMITED to ASHAFAIBRAHIM ABDULLAHIREF,transfert
04-May-2021,'0GAPS,04-May-2021.1,,"47,500.00","381,029.73",TRANSFER BETWEEN CUSTOMERS via GAPS com on Kenneth J 2M sales 112623556 0 from NETCONSTRUCT NIGERIA LIMITED to ASHAFA IBRAHIM ABDULLAHI REF: 0005628626112623556000000,SAVINGS ACCOUNT,GT_Bank,./static/raw/MR_IBRAHIM_ASHAFA_STATEMENT.pdf,TRANSFER BETWEEN CUSTOMERS via GAPS com on Kenneth J M sales from NETCONSTRUCT NIGERIA LIMITED to ASHAFA IBRAHIM ABDULLAHI REF,TRANSFER BETWEEN CUSTOMERS via GAPS com on KennethM sales from NETCONSTRUCT NIGERIA LIMITED to ASHAFA IBRAHIM ABDULLAHI REF,transfert
04-May-2021,'0NIPG,04-May-2021,"30,000.00",,"351,029.73",NIBSS Instant Payment Outward 000013210504152818000116758882 via GTWORLD  TO AISHA NAMAMA ZUBAIRU /26.875/REF:GW6819765690000003000021050415 f,SAVINGS ACCOUNT,GT_Bank,./static/raw/MR_IBRAHIM_ASHAFA_STATEMENT.pdf,NIBSS Instant Payment Outward via GTWORLD TO AISHA NAMAMA ZUBAIRU REF GW f,NIBSS Instant Payment Outward via GTWORLD TO AISHA NAMAMA ZUBAIRU REF GW,transfert
04-May-2021,'0NIPG,04-May-2021,25.00,,"351,004.73",COMMISSION 000013210504152818000116758882 NIP TRANSFER COMMISSION FOR 000013210504152818000116758882 via GTWORLD  TO AISHA NAMAMA ZUBAIRU ReF:GW681976569000000300002105041528,SAVINGS ACCOUNT,GT_Bank,./static/raw/MR_IBRAHIM_ASHAFA_STATEMENT.pdf,COMMISSION NIP TRANSFER COMMISSION FOR via GTWORLD TO AISHA NAMAMA ZUBAIRU ReF GW,COMMISSION NIP TRANSFER COMMISSION FOR via GTWORLD TO AISHA NAMAMA ZUBAIRU ReF GW,commission
04-May-2021,'0NIPG,04-May-2021,1.87,,"351,002.86",VALUE ADDED TAX 000013210504152818000116758882 VAT ON NIP TRANSFER FOR 000013210504152818000116758882 via GTWORLD  TO AISHA NAMAMA ZUBAIRU ReF:GW681976569000000300002105041528,SAVINGS ACCOUNT,GT_Bank,./static/raw/MR_IBRAHIM_ASHAFA_STATEMENT.pdf,VALUE ADDED TAX VAT ON NIP TRANSFER FOR via GTWORLD TO AISHA NAMAMA ZUBAIRU ReF GW,VALUE ADDED TAX VAT ON NIP TRANSFER FOR via GTWORLD TO AISHA NAMAMA ZUBAIRU ReF GW,tax
04-May-2021,'0NIPG,04-May-2021,"25,000.00",,"326,002.86",NIBSS Instant Payment Outward 000013210504153121000116765022 via GTWORLD  TO ABDULLAHI ASHAFA /26.875/REF:GW6819765690000002500021050415 f,SAVINGS ACCOUNT,GT_Bank,./static/raw/MR_IBRAHIM_ASHAFA_STATEMENT.pdf,NIBSS Instant Payment Outward via GTWORLD TO ABDULLAHI ASHAFA REF GW f,NIBSS Instant Payment Outward via GTWORLD TO ABDULLAHI ASHAFA REF GW,transfert
04-May-2021,'0NIPG,04-May-2021,25.00,,"325,977.86",COMMISSION 000013210504153121000116765022 NIP TRANSFER COMMISSION FOR 000013210504153121000116765022 via GTWORLD  TO ABDULLAHI ASHAFA ReF:GW681976569000000250002105041531,SAVINGS ACCOUNT,GT_Bank,./static/raw/MR_IBRAHIM_ASHAFA_STATEMENT.pdf,COMMISSION NIP TRANSFER COMMISSION FOR via GTWORLD TO ABDULLAHI ASHAFA ReF GW,COMMISSION NIP TRANSFER COMMISSION FOR via GTWORLD TO ABDULLAHI ASHAFA ReF GW,commission
04-May-2021,'0NIPG,04-May-2021,1.87,,"325,975.99",VALUE ADDED TAX 000013210504153121000116765022 VAT ON NIP TRANSFER FOR 000013210504153121000116765022 via GTWORLD  TO ABDULLAHI ASHAFA ReF:GW681976569000000250002105041531,SAVINGS ACCOUNT,GT_Bank,./static/raw/MR_IBRAHIM_ASHAFA_STATEMENT.pdf,VALUE ADDED TAX VAT ON NIP TRANSFER FOR via GTWORLD TO ABDULLAHI ASHAFA ReF GW,VALUE ADDED TAX VAT ON NIP TRANSFER FOR via GTWORLD TO ABDULLAHI ASHAFA ReF GW,tax
04-May-2021,'0NIPG,04-May-2021,"25,000.00",,"300,975.99",NIBSS Instant Payment Outward 000013210504153151000116767990 viaGTWORLD  TO ALIYU HAUWA/26.875/REF:GW6819765690000002500021050415f,SAVINGS ACCOUNT,GT_Bank,./static/raw/MR_IBRAHIM_ASHAFA_STATEMENT.pdf,NIBSS Instant Payment Outward viaGTWORLD TO ALIYU HAUWA REF GW f,NIBSS Instant Payment Outward via GTWORLD TO ALIYU HAUWA REF GW,transfert
04-May-2021,'0NIPG,04-May-2021,25.00,,"300,950.99",COMMISSION 000013210504153151000116767990NIP TRANSFER COMMISSION FOR000013210504153151000116767990 viaGTWORLD  TO ALIYU HAUWAReF:GW681976569000000250002105041532,SAVINGS ACCOUNT,GT_Bank,./static/raw/MR_IBRAHIM_ASHAFA_STATEMENT.pdf,COMMISSION NIP TRANSFER COMMISSION FOR viaGTWORLD TO ALIYU HAUWAReF GW,COMMISSION NIP TRANSFER COMMISSION FOR via GTWORLD TO ALIYU HAUWAReF GW,commission
04-May-2021,'0NIPG,04-May-2021,1.87,,"300,949.12",VALUE ADDED TAX000013210504153151000116767990 VAT ON NIPTRANSFER FOR000013210504153151000116767990 viaGTWORLD  TO ALIYU HAUWAReF:GW681976569000000250002105041532,SAVINGS ACCOUNT,GT_Bank,./static/raw/MR_IBRAHIM_ASHAFA_STATEMENT.pdf,VALUE ADDED TAX VAT ON NIPTRANSFER FOR viaGTWORLD TO ALIYU HAUWAReF GW,VALUE ADDED TAX VAT ON NIPTRANSFER FOR via GTWORLD TO ALIYU HAUWAReF GW,tax
04-May-2021,'0GWTR,04-May-2021,"30,000.00",,"270,949.12","TRANSFER BETWEEN CUSTOMERS Via GTWorldREF:681976569000000300002105041634  fromASHAFA IBRAHIM ABDULLAHI  to  SALAMI,ABUBAKAR",SAVINGS ACCOUNT,GT_Bank,./static/raw/MR_IBRAHIM_ASHAFA_STATEMENT.pdf,TRANSFER BETWEEN CUSTOMERS Via GTWorldREF fromASHAFA IBRAHIM ABDULLAHI to SALAMI ABUBAKAR,TRANSFER BETWEEN CUSTOMERS Via GTWorldREF from ASHAFA IBRAHIM ABDULLAHI to SALAMI ABUBAKAR,transfert
04-May-2021,'0NIPG,04-May-2021,"70,000.00",,"200,949.12",NIBSS Instant Payment Outward000013210504172706000117006124 viaGTWORLD  TO MUHAMMED SHABA IBRAHIM/53.75/REF:GW6819765690000007000021050417  f,SAVINGS ACCOUNT,GT_Bank,./static/raw/MR_IBRAHIM_ASHAFA_STATEMENT.pdf,NIBSS Instant Payment Outward viaGTWORLD TO MUHAMMED SHABA IBRAHIM REF GW f,NIBSS Instant Payment Outward via GTWORLD TO MUHAMMED SHABA IBRAHIM REF GW,transfert
04-May-2021,'0NIPG,04-May-2021,50.00,,"200,899.12",COMMISSION 000013210504172706000117006124NIP TRANSFER COMMISSION FOR000013210504172706000117006124 viaGTWORLD  TO MUHAMMED SHABA IBRAHIMReF:GW681976569000000700002105041727,SAVINGS ACCOUNT,GT_Bank,./static/raw/MR_IBRAHIM_ASHAFA_STATEMENT.pdf,COMMISSION NIP TRANSFER COMMISSION FOR viaGTWORLD TO MUHAMMED SHABA IBRAHIMReF GW,COMMISSION NIP TRANSFER COMMISSION FOR via GTWORLD TO MUHAMMED SHABA IBRAHIMReF GW,commission
04-May-2021,'0NIPG,04-May-2021,3.75,,"200,895.37",VALUE ADDED TAX000013210504172706000117006124 VAT ON NIPTRANSFER FOR000013210504172706000117006124 viaGTWORLD  TO MUHAMMED SHABA IBRAHIMReF:GW681976569000000700002105041727,SAVINGS ACCOUNT,GT_Bank,./static/raw/MR_IBRAHIM_ASHAFA_STATEMENT.pdf,VALUE ADDED TAX VAT ON NIPTRANSFER FOR viaGTWORLD TO MUHAMMED SHABA IBRAHIMReF GW,VALUE ADDED TAX VAT ON NIPTRANSFER FOR via GTWORLD TO MUHAMMED SHABA IBRAHIMReF GW,tax
04-May-2021,'0MBTR,04-May-2021,,"300,000.00","500,895.37","TRANSFER BETWEEN CUSTOMERS MBANKING -REF:590554532797481450001001843733 ANYAccount Transferfrom MUNDU HAUWA,MOHAMMED  to  ASHAFA IBRAHIM ABDULLAHI",SAVINGS ACCOUNT,GT_Bank,./static/raw/MR_IBRAHIM_ASHAFA_STATEMENT.pdf,TRANSFER BETWEEN CUSTOMERS MBANKING REF ANYAccount Transferfrom MUNDU HAUWA MOHAMMED to ASHAFA IBRAHIM ABDULLAHI,TRANSFER BETWEEN CUSTOMERS MBANKING REF ANYAccount Transferfrom MUNDU HAUWA MOHAMMED to ASHAFA IBRAHIM ABDULLAHI,transfert
04-May-2021,'0NIPG,04-May-2021,"130,000.00",,"370,895.37",NIBSS Instant Payment Outward000013210504192155000117212720 via GTWORLD  TO OJEIKPO MICHAEL ELAIGWU /53.75/REF:GW6819765690000013000021050419  f,SAVINGS ACCOUNT,GT_Bank,./static/raw/MR_IBRAHIM_ASHAFA_STATEMENT.pdf,NIBSS Instant Payment Outward via GTWORLD TO OJEIKPO MICHAEL ELAIGWU REF GW f,NIBSS Instant Payment Outward via GTWORLD TO OJEIKPO MICHAEL ELAIGWU REF GW,transfert
04-May-2021,'0NIPG,04-May-2021,50.00,,"370,845.37",COMMISSION 000013210504192155000117212720 NIP TRANSFER COMMISSION FOR 000013210504192155000117212720 via GTWORLD  TO OJEIKPO MICHAEL ELAIGWU ReF:GW681976569000001300002105041922,SAVINGS ACCOUNT,GT_Bank,./static/raw/MR_IBRAHIM_ASHAFA_STATEMENT.pdf,COMMISSION NIP TRANSFER COMMISSION FOR via GTWORLD TO OJEIKPO MICHAEL ELAIGWU ReF GW,COMMISSION NIP TRANSFER COMMISSION FOR via GTWORLD TO OJEIKPO MICHAEL ELAIGWU ReF GW,commission
04-May-2021,'0NIPG,04-May-2021,3.75,,"370,841.62",VALUE ADDED TAX 000013210504192155000117212720 VAT ON NIP TRANSFER FOR 000013210504192155000117212720 via GTWORLD  TO OJEIKPO MICHAEL ELAIGWU ReF:GW681976569000001300002105041922,SAVINGS ACCOUNT,GT_Bank,./static/raw/MR_IBRAHIM_ASHAFA_STATEMENT.pdf,VALUE ADDED TAX VAT ON NIP TRANSFER FOR via GTWORLD TO OJEIKPO MICHAEL ELAIGWU ReF GW,VALUE ADDED TAX VAT ON NIP TRANSFER FOR via GTWORLD TO OJEIKPO MICHAEL ELAIGWU ReF GW,tax
04-May-2021,'0NIPG,04-May-2021,"200,000.00",,"170,841.62",NIBSS Instant Payment Outward 000013210504192314000117214742 via GTWORLD  TO IBRAHIM ASHAFA /53.75/REF:GW6819765690000020000021050419  f,SAVINGS ACCOUNT,GT_Bank,./static/raw/MR_IBRAHIM_ASHAFA_STATEMENT.pdf,NIBSS Instant Payment Outward via GTWORLD TO IBRAHIM ASHAFA REF GW f,NIBSS Instant Payment Outward via GTWORLD TO IBRAHIM ASHAFA REF GW,transfert
04-May-2021,'0NIPG,04-May-2021,50.00,,"170,791.62",COMMISSION 000013210504192314000117214742 NIP TRANSFER COMMISSION FOR 000013210504192314000117214742 via GTWORLD  TO IBRAHIM ASHAFA ReF:GW681976569000002000002105041924,SAVINGS ACCOUNT,GT_Bank,./static/raw/MR_IBRAHIM_ASHAFA_STATEMENT.pdf,COMMISSION NIP TRANSFER COMMISSION FOR via GTWORLD TO IBRAHIM ASHAFA ReF GW,COMMISSION NIP TRANSFER COMMISSION FOR via GTWORLD TO IBRAHIM ASHAFA ReF GW,commission
04-May-2021,'0NIPG,04-May-2021,3.75,,"170,787.87",VALUE ADDED TAX 000013210504192314000117214742 VAT ON NIP TRANSFER FOR 000013210504192314000117214742 via GTWORLD  TO IBRAHIM ASHAFA ReF:GW681976569000002000002105041924,SAVINGS ACCOUNT,GT_Bank,./static/raw/MR_IBRAHIM_ASHAFA_STATEMENT.pdf,VALUE ADDED TAX VAT ON NIP TRANSFER FOR via GTWORLD TO IBRAHIM ASHAFA ReF GW,VALUE ADDED TAX VAT ON NIP TRANSFER FOR via GTWORLD TO IBRAHIM ASHAFA ReF GW,tax
04-May-2021,'0NIPG,04-May-2021,"30,000.00",,"140,787.87",NIBSS Instant Payment Outward 000013210504194135000117240083 via GTWORLD  TO YAKUBU ASHAFA ABDULLAHI /26.875/REF:GW6819765690000003000021050419 f,SAVINGS ACCOUNT,GT_Bank,./static/raw/MR_IBRAHIM_ASHAFA_STATEMENT.pdf,NIBSS Instant Payment Outward via GTWORLD TO YAKUBU ASHAFA ABDULLAHI REF GW f,NIBSS Instant Payment Outward via GTWORLD TO YAKUBU ASHAFA ABDULLAHI REF GW,transfert
04-May-2021,'0NIPG,04-May-2021,25.00,,"140,762.87",COMMISSION 000013210504194135000117240083 NIP TRANSFER COMMISSION FOR 000013210504194135000117240083 via GTWORLD  TO YAKUBU ASHAFA ABDULLAHI ReF:GW681976569000000300002105041940,SAVINGS ACCOUNT,GT_Bank,./static/raw/MR_IBRAHIM_ASHAFA_STATEMENT.pdf,COMMISSION NIP TRANSFER COMMISSION FOR via GTWORLD TO YAKUBU ASHAFA ABDULLAHI ReF GW,COMMISSION NIP TRANSFER COMMISSION FOR via GTWORLD TO YAKUBU ASHAFA ABDULLAHI ReF GW,commission
04-May-2021,'0NIPG,04-May-2021.1,1.87,,"140,761.00",VALUE ADDED TAX 000013210504194135000117240083 VAT ON NIP TRANSFER FOR 000013210504194135000117240083 via GTWORLD  TO YAKUBU ASHAFA ABDULLAHI ReF:GW681976569000000300002105041940,SAVINGS ACCOUNT,GT_Bank,./static/raw/MR_IBRAHIM_ASHAFA_STATEMENT.pdf,VALUE ADDED TAX VAT ON NIP TRANSFER FOR via GTWORLD TO YAKUBU ASHAFA ABDULLAHI ReF GW,VALUE ADDED TAX VAT ON NIP TRANSFER FOR via GTWORLD TO YAKUBU ASHAFA ABDULLAHI ReF GW,tax
04-May-2021,'0NIPG,04-May-2021,"1,500.00",,"139,261.00",NIBSS Instant Payment Outward 000013210504204930000117334699 via GTWORLD  TO HUSSAINI YUSUF /10.75/REF:GW6819765690000000150021050420  f,SAVINGS ACCOUNT,GT_Bank,./static/raw/MR_IBRAHIM_ASHAFA_STATEMENT.pdf,NIBSS Instant Payment Outward via GTWORLD TO HUSSAINI YUSUF REF GW f,NIBSS Instant Payment Outward via GTWORLD TO HUSSAINI YUSUF REF GW,transfert
04-May-2021,'0NIPG,04-May-2021,10.00,,"139,251.00",COMMISSION 000013210504204930000117334699 NIP TRANSFER COMMISSION FOR 000013210504204930000117334699 via GTWORLD  TO HUSSAINI YUSUF ReF:GW681976569000000015002105042049,SAVINGS ACCOUNT,GT_Bank,./static/raw/MR_IBRAHIM_ASHAFA_STATEMENT.pdf,COMMISSION NIP TRANSFER COMMISSION FOR via GTWORLD TO HUSSAINI YUSUF ReF GW,COMMISSION NIP TRANSFER COMMISSION FOR via GTWORLD TO HUSSAINI YUSUF ReF GW,commission
04-May-2021,'0NIPG,04-May-2021,.75,,"139,250.25",VALUE ADDED TAX 000013210504204930000117334699 VAT ON NIP TRANSFER FOR 000013210504204930000117334699 via GTWORLD  TO HUSSAINI YUSUF ReF:GW681976569000000015002105042049,SAVINGS ACCOUNT,GT_Bank,./static/raw/MR_IBRAHIM_ASHAFA_STATEMENT.pdf,VALUE ADDED TAX VAT ON NIP TRANSFER FOR via GTWORLD TO HUSSAINI YUSUF ReF GW,VALUE ADDED TAX VAT ON NIP TRANSFER FOR via GTWORLD TO HUSSAINI YUSUF ReF GW,tax
04-May-2021,'0USAT,04-May-2021,"1,000.00",,"138,250.25",Airtime Purchase GTWORLD- 101CT0000000002565580452-2348038673032,SAVINGS ACCOUNT,GT_Bank,./static/raw/MR_IBRAHIM_ASHAFA_STATEMENT.pdf,Airtime Purchase GTWORLD CT,Airtime Purchase GTWORLD CT,utility
04-May-2021,'0NIPG,04-May-2021,"3,000.00",,"135,250.25",NIBSS Instant Payment Outward 000013210504211011000117362031 via GTWORLD  TO HUSSAINI YUSUF /10.75/REF:GW6819765690000000300021050421  f,SAVINGS ACCOUNT,GT_Bank,./static/raw/MR_IBRAHIM_ASHAFA_STATEMENT.pdf,NIBSS Instant Payment Outward via GTWORLD TO HUSSAINI YUSUF REF GW f,NIBSS Instant Payment Outward via GTWORLD TO HUSSAINI YUSUF REF GW,transfert
04-May-2021,'0NIPG,04-May-2021,10.00,,"135,240.25",COMMISSION 000013210504211011000117362031 NIP TRANSFER COMMISSION FOR 000013210504211011000117362031 via GTWORLD  TO HUSSAINI YUSUF ReF:GW681976569000000030002105042111,SAVINGS ACCOUNT,GT_Bank,./static/raw/MR_IBRAHIM_ASHAFA_STATEMENT.pdf,COMMISSION NIP TRANSFER COMMISSION FOR via GTWORLD TO HUSSAINI YUSUF ReF GW,COMMISSION NIP TRANSFER COMMISSION FOR via GTWORLD TO HUSSAINI YUSUF ReF GW,commission
04-May-2021,'0NIPG,04-May-2021,.75,,"135,239.50",VALUE ADDED TAX 000013210504211011000117362031 VAT ON NIP TRANSFER FOR 000013210504211011000117362031 via GTWORLD  TO HUSSAINI YUSUF ReF:GW681976569000000030002105042111,SAVINGS ACCOUNT,GT_Bank,./static/raw/MR_IBRAHIM_ASHAFA_STATEMENT.pdf,VALUE ADDED TAX VAT ON NIP TRANSFER FOR via GTWORLD TO HUSSAINI YUSUF ReF GW,VALUE ADDED TAX VAT ON NIP TRANSFER FOR via GTWORLD TO HUSSAINI YUSUF ReF GW,tax
05-May-2021,'0,04-May-2021,150.00,,"135,089.50",STAMP DUTY CHARGE 04052021 STAMP DUTY CHARGE - 04/05/2021,SAVINGS ACCOUNT,GT_Bank,./static/raw/MR_IBRAHIM_ASHAFA_STATEMENT.pdf,STAMP DUTY CHARGE STAMP DUTY CHARGE,STAMP DUTY CHARGE STAMP DUTY CHARGE,bank_charges
05-May-2021,'0USAT,05-May-2021,800.00,,"134,289.50",Airtime Purchase GTWORLD_QL- 101CT0000000002568342240-2348030549818,SAVINGS ACCOUNT,GT_Bank,./static/raw/MR_IBRAHIM_ASHAFA_STATEMENT.pdf,Airtime Purchase GTWORLD_QL CT,Airtime Purchase GTWORLDQL CT,utility
06-May-2021,'0NIPG,06-May-2021,"4,000.00",,"130,289.50",NIBSS Instant Payment Outward 000013210506120405000119812823 via GTWORLD  TO YAKUBU SHEMAU ASHAFA /10.75/REF:GW6819765690000000400021050612  f,SAVINGS ACCOUNT,GT_Bank,./static/raw/MR_IBRAHIM_ASHAFA_STATEMENT.pdf,NIBSS Instant Payment Outward via GTWORLD TO YAKUBU SHEMAU ASHAFA REF GW f,NIBSS Instant Payment Outward via GTWORLD TO YAKUBU SHEMAU ASHAFA REF GW,transfert
06-May-2021,'0NIPG,06-May-2021,10.00,,"130,279.50",COMMISSION 000013210506120405000119812823 NIP TRANSFER COMMISSION FOR 000013210506120405000119812823 via GTWORLD  TO YAKUBU SHEMAU ASHAFA ReF:GW681976569000000040002105061205,SAVINGS ACCOUNT,GT_Bank,./static/raw/MR_IBRAHIM_ASHAFA_STATEMENT.pdf,COMMISSION NIP TRANSFER COMMISSION FOR via GTWORLD TO YAKUBU SHEMAU ASHAFA ReF GW,COMMISSION NIP TRANSFER COMMISSION FOR via GTWORLD TO YAKUBU SHEMAU ASHAFA ReF GW,commission
06-May-2021,'0NIPG,06-May-2021,.75,,"130,278.75",VALUE ADDED TAX 000013210506120405000119812823 VAT ON NIP TRANSFER FOR 000013210506120405000119812823 via GTWORLD  TO YAKUBU SHEMAU ASHAFA ReF:GW681976569000000040002105061205,SAVINGS ACCOUNT,GT_Bank,./static/raw/MR_IBRAHIM_ASHAFA_STATEMENT.pdf,VALUE ADDED TAX VAT ON NIP TRANSFER FOR via GTWORLD TO YAKUBU SHEMAU ASHAFA ReF GW,VALUE ADDED TAX VAT ON NIP TRANSFER FOR via GTWORLD TO YAKUBU SHEMAU ASHAFA ReF GW,tax
06-May-2021,'0NIPT,06-May-2021,,"15,000.00","145,278.75",TRANSFER BETWEEN CUSTOMERS 000015210506191707001706118200|Ashafa|43655 5013||SHEHU M. ALIYU REF:000015210506191707001706118200,SAVINGS ACCOUNT,GT_Bank,./static/raw/MR_IBRAHIM_ASHAFA_STATEMENT.pdf,TRANSFER BETWEEN CUSTOMERS Ashafa SHEHU M ALIYU REF,TRANSFER BETWEEN CUSTOMERS Ashafa SHEHUALIYU REF,transfert
06-May-2021,'0NIPG,06-May-2021,"5,000.00",,"140,278.75",NIBSS Instant Payment Outward 000013210506222925000120914535 via GTWORLD  TO HUZAIFA AL-AMIYU IBRAHIM /10.75/REF:GW6819765690000000500021050622  f,SAVINGS ACCOUNT,GT_Bank,./static/raw/MR_IBRAHIM_ASHAFA_STATEMENT.pdf,NIBSS Instant Payment Outward via GTWORLD TO HUZAIFA AL AMIYU IBRAHIM REF GW f,NIBSS Instant Payment Outward via GTWORLD TO HUZAIFA AL AMIYU IBRAHIM REF GW,transfert
06-May-2021,'0NIPG,06-May-2021,10.00,,"140,268.75",COMMISSION 000013210506222925000120914535 NIP TRANSFER COMMISSION FOR 000013210506222925000120914535 via GTWORLD  TO HUZAIFA AL-AMIYU IBRAHIM ReF:GW681976569000000050002105062229,SAVINGS ACCOUNT,GT_Bank,./static/raw/MR_IBRAHIM_ASHAFA_STATEMENT.pdf,COMMISSION NIP TRANSFER COMMISSION FOR via GTWORLD TO HUZAIFA AL AMIYU IBRAHIM ReF GW,COMMISSION NIP TRANSFER COMMISSION FOR via GTWORLD TO HUZAIFA AL AMIYU IBRAHIM ReF GW,commission
06-May-2021,'0NIPG,06-May-2021,.75,,"140,268.00",VALUE ADDED TAX 000013210506222925000120914535 VAT ON NIP TRANSFER FOR 000013210506222925000120914535 via GTWORLD  TO HUZAIFA AL-AMIYU IBRAHIM ReF:GW681976569000000050002105062229,SAVINGS ACCOUNT,GT_Bank,./static/raw/MR_IBRAHIM_ASHAFA_STATEMENT.pdf,VALUE ADDED TAX VAT ON NIP TRANSFER FOR via GTWORLD TO HUZAIFA AL AMIYU IBRAHIM ReF GW,VALUE ADDED TAX VAT ON NIP TRANSFER FOR via GTWORLD TO HUZAIFA AL AMIYU IBRAHIM ReF GW,tax
07-May-2021,'0,06-May-2021,50.00,,"140,218.00",STAMP DUTY CHARGE 06052021 STAMP DUTY CHARGE - 06/05/2021,SAVINGS ACCOUNT,GT_Bank,./static/raw/MR_IBRAHIM_ASHAFA_STATEMENT.pdf,STAMP DUTY CHARGE STAMP DUTY CHARGE,STAMP DUTY CHARGE STAMP DUTY CHARGE,bank_charges
07-May-2021,'0NIPG,07-May-2021,"5,000.00",,"135,218.00",NIBSS Instant Payment Outward 000013210507082634000121135069 via GTWORLD  TO DAUDA IBRAHIM ABUBAKAR /10.75/REF:GW6819765690000000500021050708  f,SAVINGS ACCOUNT,GT_Bank,./static/raw/MR_IBRAHIM_ASHAFA_STATEMENT.pdf,NIBSS Instant Payment Outward via GTWORLD TO DAUDA IBRAHIM ABUBAKAR REF GW f,NIBSS Instant Payment Outward via GTWORLD TO DAUDA IBRAHIM ABUBAKAR REF GW,transfert
07-May-2021,'0NIPG,07-May-2021,10.00,,"135,208.00",COMMISSION 000013210507082634000121135069 NIP TRANSFER COMMISSION FOR 000013210507082634000121135069 via GTWORLD  TO DAUDA IBRAHIM ABUBAKAR ReF:GW681976569000000050002105070825,SAVINGS ACCOUNT,GT_Bank,./static/raw/MR_IBRAHIM_ASHAFA_STATEMENT.pdf,COMMISSION NIP TRANSFER COMMISSION FOR via GTWORLD TO DAUDA IBRAHIM ABUBAKAR ReF GW,COMMISSION NIP TRANSFER COMMISSION FOR via GTWORLD TO DAUDA IBRAHIM ABUBAKAR ReF GW,commission
07-May-2021,'0NIPG,07-May-2021,.75,,"135,207.25",VALUE ADDED TAX 000013210507082634000121135069 VAT ON NIP TRANSFER FOR 000013210507082634000121135069 via GTWORLD  TO DAUDA IBRAHIM ABUBAKAR ReF:GW681976569000000050002105070825,SAVINGS ACCOUNT,GT_Bank,./static/raw/MR_IBRAHIM_ASHAFA_STATEMENT.pdf,VALUE ADDED TAX VAT ON NIP TRANSFER FOR via GTWORLD TO DAUDA IBRAHIM ABUBAKAR ReF GW,VALUE ADDED TAX VAT ON NIP TRANSFER FOR via GTWORLD TO DAUDA IBRAHIM ABUBAKAR ReF GW,tax
07-May-2021,'0NIPG,07-May-2021,"5,000.00",,"130,207.25",NIBSS Instant Payment Outward 000013210507094810000121278495 via GTWORLD  TO JIBRIN BASIRAH USMAN /10.75/REF:GW6819765690000000500021050709  f,SAVINGS ACCOUNT,GT_Bank,./static/raw/MR_IBRAHIM_ASHAFA_STATEMENT.pdf,NIBSS Instant Payment Outward via GTWORLD TO JIBRIN BASIRAH USMAN REF GW f,NIBSS Instant Payment Outward via GTWORLD TO JIBRIN BASIRAH USMAN REF GW,transfert
07-May-2021,'0NIPG,07-May-2021,10.00,,"130,197.25",COMMISSION 000013210507094810000121278495 NIP TRANSFER COMMISSION FOR 000013210507094810000121278495 via GTWORLD  TO JIBRIN BASIRAH USMAN ReF:GW681976569000000050002105070946,SAVINGS ACCOUNT,GT_Bank,./static/raw/MR_IBRAHIM_ASHAFA_STATEMENT.pdf,COMMISSION NIP TRANSFER COMMISSION FOR via GTWORLD TO JIBRIN BASIRAH USMAN ReF GW,COMMISSION NIP TRANSFER COMMISSION FOR via GTWORLD TO JIBRIN BASIRAH USMAN ReF GW,commission
07-May-2021,'0NIPG,07-May-2021,.75,,"130,196.50",VALUE ADDED TAX 000013210507094810000121278495 VAT ON NIP TRANSFER FOR 000013210507094810000121278495 via GTWORLD  TO JIBRIN BASIRAH USMAN ReF:GW681976569000000050002105070946,SAVINGS ACCOUNT,GT_Bank,./static/raw/MR_IBRAHIM_ASHAFA_STATEMENT.pdf,VALUE ADDED TAX VAT ON NIP TRANSFER FOR via GTWORLD TO JIBRIN BASIRAH USMAN ReF GW,VALUE ADDED TAX VAT ON NIP TRANSFER FOR via GTWORLD TO JIBRIN BASIRAH USMAN ReF GW,tax
07-May-2021,'0GAPS,07-May-2021,,"22,800.00","152,996.50",TRANSFER BETWEEN CUSTOMERS via GAPS com on Azubike M 1.6M sales 112850275 0 from NETCONSTRUCT NIGERIA LIMITED to ASHAFA IBRAHIM ABDULLAHI REF: 0005628626112850275000000,SAVINGS ACCOUNT,GT_Bank,./static/raw/MR_IBRAHIM_ASHAFA_STATEMENT.pdf,TRANSFER BETWEEN CUSTOMERS via GAPS com on Azubike M M sales from NETCONSTRUCT NIGERIA LIMITED to ASHAFA IBRAHIM ABDULLAHI REF,TRANSFER BETWEEN CUSTOMERS via GAPS com on AzubikeM sales from NETCONSTRUCT NIGERIA LIMITED to ASHAFA IBRAHIM ABDULLAHI REF,transfert
07-May-2021,'0USAT,07-May-2021,"1,000.00",,"151,996.50",Airtime Purchase GTWORLD_QL-101CT0000000002571822649-2348109828886,SAVINGS ACCOUNT,GT_Bank,./static/raw/MR_IBRAHIM_ASHAFA_STATEMENT.pdf,Airtime Purchase GTWORLD_QL CT,Airtime Purchase GTWORLDQL CT,utility
07-May-2021,'0USAT,07-May-2021,800.00,,"151,196.50",Airtime Purchase GTWORLD_QL- 101CT0000000002571824021-2348030549818,SAVINGS ACCOUNT,GT_Bank,./static/raw/MR_IBRAHIM_ASHAFA_STATEMENT.pdf,Airtime Purchase GTWORLD_QL CT,Airtime Purchase GTWORLDQL CT,utility
07-May-2021,'0USAT,07-May-2021,900.00,,"150,296.50",Airtime Purchase GTWORLD_QL- 101CT0000000002571825897-2348038673032,SAVINGS ACCOUNT,GT_Bank,./static/raw/MR_IBRAHIM_ASHAFA_STATEMENT.pdf,Airtime Purchase GTWORLD_QL CT,Airtime Purchase GTWORLDQL CT,utility
07-May-2021,'0NIPG,07-May-2021,"5,000.00",,"145,296.50",NIBSS Instant Payment Outward 000013210507143243000121857041 via GTWORLD  TO UMAR ISAH RABIU /10.75/REF:GW6819765690000000500021050714  f,SAVINGS ACCOUNT,GT_Bank,./static/raw/MR_IBRAHIM_ASHAFA_STATEMENT.pdf,NIBSS Instant Payment Outward via GTWORLD TO UMAR ISAH RABIU REF GW f,NIBSS Instant Payment Outward via GTWORLD TO UMAR ISAH RABIU REF GW,transfert
07-May-2021,'0NIPG,07-May-2021,10.00,,"145,286.50",COMMISSION 000013210507143243000121857041 NIP TRANSFER COMMISSION FOR 000013210507143243000121857041 via GTWORLD  TO UMAR ISAH RABIU ReF:GW681976569000000050002105071432,SAVINGS ACCOUNT,GT_Bank,./static/raw/MR_IBRAHIM_ASHAFA_STATEMENT.pdf,COMMISSION NIP TRANSFER COMMISSION FOR via GTWORLD TO UMAR ISAH RABIU ReF GW,COMMISSION NIP TRANSFER COMMISSION FOR via GTWORLD TO UMAR ISAH RABIU ReF GW,commission
07-May-2021,'0NIPG,07-May-2021,.75,,"145,285.75",VALUE ADDED TAX 000013210507143243000121857041 VAT ON NIP TRANSFER FOR 000013210507143243000121857041 via GTWORLD  TO UMAR ISAH RABIU ReF:GW681976569000000050002105071432,SAVINGS ACCOUNT,GT_Bank,./static/raw/MR_IBRAHIM_ASHAFA_STATEMENT.pdf,VALUE ADDED TAX VAT ON NIP TRANSFER FOR via GTWORLD TO UMAR ISAH RABIU ReF GW,VALUE ADDED TAX VAT ON NIP TRANSFER FOR via GTWORLD TO UMAR ISAH RABIU ReF GW,tax
08-May-2021,'0,07-May-2021,50.00,,"145,235.75",STAMP DUTY CHARGE 07052021 STAMP DUTY CHARGE - 07/05/2021,SAVINGS ACCOUNT,GT_Bank,./static/raw/MR_IBRAHIM_ASHAFA_STATEMENT.pdf,STAMP DUTY CHARGE STAMP DUTY CHARGE,STAMP DUTY CHARGE STAMP DUTY CHARGE,bank_charges
08-May-2021,'0NIPG,08-May-2021,"20,000.00",,"125,235.75",NIBSS Instant Payment Outward 000013210508063738000122798324 via GTWORLD  TO AISHA NAMAMA ZUBAIRU /26.875/REF:GW6819765690000002000021050806 f,SAVINGS ACCOUNT,GT_Bank,./static/raw/MR_IBRAHIM_ASHAFA_STATEMENT.pdf,NIBSS Instant Payment Outward via GTWORLD TO AISHA NAMAMA ZUBAIRU REF GW f,NIBSS Instant Payment Outward via GTWORLD TO AISHA NAMAMA ZUBAIRU REF GW,transfert
08-May-2021,'0NIPG,08-May-2021,25.00,,"125,210.75",COMMISSION 000013210508063738000122798324 NIP TRANSFER COMMISSION FOR 000013210508063738000122798324 via GTWORLD  TO AISHA NAMAMA ZUBAIRU ReF:GW681976569000000200002105080636,SAVINGS ACCOUNT,GT_Bank,./static/raw/MR_IBRAHIM_ASHAFA_STATEMENT.pdf,COMMISSION NIP TRANSFER COMMISSION FOR via GTWORLD TO AISHA NAMAMA ZUBAIRU ReF GW,COMMISSION NIP TRANSFER COMMISSION FOR via GTWORLD TO AISHA NAMAMA ZUBAIRU ReF GW,commission
08-May-2021,'0NIPG,08-May-2021,1.87,,"125,208.88",VALUE ADDED TAX 000013210508063738000122798324 VAT ON NIP TRANSFER FOR 000013210508063738000122798324 via GTWORLD  TO AISHA NAMAMA ZUBAIRU ReF:GW681976569000000200002105080636,SAVINGS ACCOUNT,GT_Bank,./static/raw/MR_IBRAHIM_ASHAFA_STATEMENT.pdf,VALUE ADDED TAX VAT ON NIP TRANSFER FOR via GTWORLD TO AISHA NAMAMA ZUBAIRU ReF GW,VALUE ADDED TAX VAT ON NIP TRANSFER FOR via GTWORLD TO AISHA NAMAMA ZUBAIRU ReF GW,tax
09-May-2021,'0GWTR,09-May-2021.1,"10,000.00",,"115,208.88","TRANSFER BETWEEN CUSTOMERS Via GTWorld REF:681976569000000100002105091230  from ASHAFA IBRAHIM ABDULLAHI  to  SALAMI, ABUBAKAR",SAVINGS ACCOUNT,GT_Bank,./static/raw/MR_IBRAHIM_ASHAFA_STATEMENT.pdf,TRANSFER BETWEEN CUSTOMERS Via GTWorld REF from ASHAFA IBRAHIM ABDULLAHI to SALAMI ABUBAKAR,TRANSFER BETWEEN CUSTOMERS Via GTWorld REF from ASHAFA IBRAHIM ABDULLAHI to SALAMI ABUBAKAR,transfert
10-May-2021,'0NIPT,10-May-2021,,"5,000.00","120,208.88",TRANSFER BETWEEN CUSTOMERS 000016210510111638000060354589|FBNMOBILE: ASHAFA IBRAHIM ABDULLAHI/GIFTS|637562421984086100||AYEGB A-KING GRACE EHI REF:000016210510111638000060354589,SAVINGS ACCOUNT,GT_Bank,./static/raw/MR_IBRAHIM_ASHAFA_STATEMENT.pdf,TRANSFER BETWEEN CUSTOMERS FBNMOBILE ASHAFA IBRAHIM ABDULLAHI GIFTS AYEGB A KING GRACE EHI REF,TRANSFER BETWEEN CUSTOMERS FBNMOBILE ASHAFA IBRAHIM ABDULLAHI GIFTS AYEGBKING GRACE EHI REF,transfert
10-May-2021,'0GWTR,10-May-2021,"5,000.00",,"115,208.88","TRANSFER BETWEEN CUSTOMERS Via GTWorld REF:681976569000000050002105101708  from ASHAFA IBRAHIM ABDULLAHI  to  PATRICK, INNOCENT ABAH",SAVINGS ACCOUNT,GT_Bank,./static/raw/MR_IBRAHIM_ASHAFA_STATEMENT.pdf,TRANSFER BETWEEN CUSTOMERS Via GTWorld REF from ASHAFA IBRAHIM ABDULLAHI to PATRICK INNOCENT ABAH,TRANSFER BETWEEN CUSTOMERS Via GTWorld REF from ASHAFA IBRAHIM ABDULLAHI to PATRICK INNOCENT ABAH,transfert
10-May-2021,'0USAT,10-May-2021,"1,000.00",,"114,208.88",Airtime Purchase GTWORLD_QL- 101CT0000000002581115949-2348038673032,SAVINGS ACCOUNT,GT_Bank,./static/raw/MR_IBRAHIM_ASHAFA_STATEMENT.pdf,Airtime Purchase GTWORLD_QL CT,Airtime Purchase GTWORLDQL CT,utility
11-May-2021,'0GWTR,11-May-2021,"2,000.00",,"112,208.88","TRANSFER BETWEEN CUSTOMERS Via GTWorld REF:681976569000000020002105110515  from ASHAFA IBRAHIM ABDULLAHI  to  ALIYU, ASHAFA NASIR",SAVINGS ACCOUNT,GT_Bank,./static/raw/MR_IBRAHIM_ASHAFA_STATEMENT.pdf,TRANSFER BETWEEN CUSTOMERS Via GTWorld REF from ASHAFA IBRAHIM ABDULLAHI to ALIYU ASHAFA NASIR,TRANSFER BETWEEN CUSTOMERS Via GTWorld REF from ASHAFA IBRAHIM ABDULLAHI to ALIYU ASHAFA NASIR,transfert
11-May-2021,'0NIPG,11-May-2021,"4,000.00",,"108,208.88",NIBSS Instant Payment Outward 000013210511091113000127420728 via GTWORLD  TO SULEIMAN MOHAMMED ASHAFA /10.75/REF:GW6819765690000000400021051109  f,SAVINGS ACCOUNT,GT_Bank,./static/raw/MR_IBRAHIM_ASHAFA_STATEMENT.pdf,NIBSS Instant Payment Outward via GTWORLD TO SULEIMAN MOHAMMED ASHAFA REF GW f,NIBSS Instant Payment Outward via GTWORLD TO SULEIMAN MOHAMMED ASHAFA REF GW,transfert
11-May-2021,'0NIPG,11-May-2021,10.00,,"108,198.88",COMMISSION 000013210511091113000127420728 NIP TRANSFER COMMISSION FOR 000013210511091113000127420728 via GTWORLD  TO SULEIMAN MOHAMMED ASHAFA ReF:GW681976569000000040002105110911,SAVINGS ACCOUNT,GT_Bank,./static/raw/MR_IBRAHIM_ASHAFA_STATEMENT.pdf,COMMISSION NIP TRANSFER COMMISSION FOR via GTWORLD TO SULEIMAN MOHAMMED ASHAFA ReF GW,COMMISSION NIP TRANSFER COMMISSION FOR via GTWORLD TO SULEIMAN MOHAMMED ASHAFA ReF GW,commission
11-May-2021,'0NIPG,11-May-2021,.75,,"108,198.13",VALUE ADDED TAX 000013210511091113000127420728 VAT ON NIP TRANSFER FOR 000013210511091113000127420728 via GTWORLD  TO SULEIMAN MOHAMMED ASHAFA ReF:GW681976569000000040002105110911,SAVINGS ACCOUNT,GT_Bank,./static/raw/MR_IBRAHIM_ASHAFA_STATEMENT.pdf,VALUE ADDED TAX VAT ON NIP TRANSFER FOR via GTWORLD TO SULEIMAN MOHAMMED ASHAFA ReF GW,VALUE ADDED TAX VAT ON NIP TRANSFER FOR via GTWORLD TO SULEIMAN MOHAMMED ASHAFA ReF GW,tax
11-May-2021,'2946240000,11-May-2021,"8,000.00",,"100,198.13",POS/WEB PURCHASE TRANSACTION  -294624- - 780604-SHEMA PETROLEUM LIMI   KD KDNG,SAVINGS ACCOUNT,GT_Bank,./static/raw/MR_IBRAHIM_ASHAFA_STATEMENT.pdf,POS WEB PURCHASE TRANSACTION SHEMA PETROLEUM LIMI KD KDNG,POS WEB PURCHASE TRANSACTION SHEMA PETROLEUM LIMI KD KDNG,utility
11-May-2021,'99990145079999,11-May-2021.1,"1,850.00",,"98,348.13",POS/WEB PURCHASE TRANSACTION  -014507- - 855255-OJUELEGBA RESTAURANT & FC LANG,SAVINGS ACCOUNT,GT_Bank,./static/raw/MR_IBRAHIM_ASHAFA_STATEMENT.pdf,POS WEB PURCHASE TRANSACTION OJUELEGBA RESTAURANT FC LANG,POS WEB PURCHASE TRANSACTION OJUELEGBA RESTAURANT FC LANG,utility
11-May-2021,'0MBTR,11-May-2021,,"25,000.00","123,348.13",TRANSFER BETWEEN CUSTOMERS MBANKING - REF:795908115339843700006558177317 ANY Account Transfer   from HALILU AHMED  to ASHAFA IBRAHIM ABDULLAHI,SAVINGS ACCOUNT,GT_Bank,./static/raw/MR_IBRAHIM_ASHAFA_STATEMENT.pdf,TRANSFER BETWEEN CUSTOMERS MBANKING REF ANY Account Transfer from HALILU AHMED to ASHAFA IBRAHIM ABDULLAHI,TRANSFER BETWEEN CUSTOMERS MBANKING REF ANY Account Transfer from HALILU AHMED to ASHAFA IBRAHIM ABDULLAHI,transfert
11-May-2021,'0NIPG,11-May-2021,"3,000.00",,"120,348.13",NIBSS Instant Payment Outward 000013210511172256000128432793 via GTWORLD  TO SULEIMAN ADAMU DANLAMI /10.75/REF:GW6819765690000000300021051117  f,SAVINGS ACCOUNT,GT_Bank,./static/raw/MR_IBRAHIM_ASHAFA_STATEMENT.pdf,NIBSS Instant Payment Outward via GTWORLD TO SULEIMAN ADAMU DANLAMI REF GW f,NIBSS Instant Payment Outward via GTWORLD TO SULEIMAN ADAMU DANLAMI REF GW,transfert
11-May-2021,'0NIPG,11-May-2021,10.00,,"120,338.13",COMMISSION 000013210511172256000128432793 NIP TRANSFER COMMISSION FOR 000013210511172256000128432793 via GTWORLD  TO SULEIMAN ADAMU DANLAMI ReF:GW681976569000000030002105111722,SAVINGS ACCOUNT,GT_Bank,./static/raw/MR_IBRAHIM_ASHAFA_STATEMENT.pdf,COMMISSION NIP TRANSFER COMMISSION FOR via GTWORLD TO SULEIMAN ADAMU DANLAMI ReF GW,COMMISSION NIP TRANSFER COMMISSION FOR via GTWORLD TO SULEIMAN ADAMU DANLAMI ReF GW,commission
11-May-2021,'0NIPG,11-May-2021,.75,,"120,337.38",VALUE ADDED TAX 000013210511172256000128432793 VAT ON NIP TRANSFER FOR 000013210511172256000128432793 via GTWORLD  TO SULEIMAN ADAMU DANLAMI ReF:GW681976569000000030002105111722,SAVINGS ACCOUNT,GT_Bank,./static/raw/MR_IBRAHIM_ASHAFA_STATEMENT.pdf,VALUE ADDED TAX VAT ON NIP TRANSFER FOR via GTWORLD TO SULEIMAN ADAMU DANLAMI ReF GW,VALUE ADDED TAX VAT ON NIP TRANSFER FOR via GTWORLD TO SULEIMAN ADAMU DANLAMI ReF GW,tax
11-May-2021,'0NIPG,11-May-2021,"10,000.00",,"110,337.38",NIBSS Instant Payment Outward 000013210511172331000128434364 via GTWORLD  TO YAKUBU ASHAFA ABDULLAHI /26.875/REF:GW6819765690000001000021051117 f,SAVINGS ACCOUNT,GT_Bank,./static/raw/MR_IBRAHIM_ASHAFA_STATEMENT.pdf,NIBSS Instant Payment Outward via GTWORLD TO YAKUBU ASHAFA ABDULLAHI REF GW f,NIBSS Instant Payment Outward via GTWORLD TO YAKUBU ASHAFA ABDULLAHI REF GW,transfert
11-May-2021,'0NIPG,11-May-2021,25.00,,"110,312.38",COMMISSION 000013210511172331000128434364 NIP TRANSFER COMMISSION FOR 000013210511172331000128434364 via GTWORLD  TO YAKUBU ASHAFA ABDULLAHI ReF:GW681976569000000100002105111723,SAVINGS ACCOUNT,GT_Bank,./static/raw/MR_IBRAHIM_ASHAFA_STATEMENT.pdf,COMMISSION NIP TRANSFER COMMISSION FOR via GTWORLD TO YAKUBU ASHAFA ABDULLAHI ReF GW,COMMISSION NIP TRANSFER COMMISSION FOR via GTWORLD TO YAKUBU ASHAFA ABDULLAHI ReF GW,commission
11-May-2021,'0NIPG,11-May-2021,1.87,,"110,310.51",VALUE ADDED TAX 000013210511172331000128434364 VAT ON NIP TRANSFER FOR 000013210511172331000128434364 via GTWORLD  TO YAKUBU ASHAFA ABDULLAHI ReF:GW681976569000000100002105111723,SAVINGS ACCOUNT,GT_Bank,./static/raw/MR_IBRAHIM_ASHAFA_STATEMENT.pdf,VALUE ADDED TAX VAT ON NIP TRANSFER FOR via GTWORLD TO YAKUBU ASHAFA ABDULLAHI ReF GW,VALUE ADDED TAX VAT ON NIP TRANSFER FOR via GTWORLD TO YAKUBU ASHAFA ABDULLAHI ReF GW,tax
12-May-2021,'0NIPG,12-May-2021.1,"1,200.00",,"109,110.51",NIBSS Instant Payment Outward 000013210512074538000129121977 via GTWORLD  TO HUSSAINI YUSUF /10.75/REF:GW6819765690000000120021051207  f,SAVINGS ACCOUNT,GT_Bank,./static/raw/MR_IBRAHIM_ASHAFA_STATEMENT.pdf,NIBSS Instant Payment Outward via GTWORLD TO HUSSAINI YUSUF REF GW f,NIBSS Instant Payment Outward via GTWORLD TO HUSSAINI YUSUF REF GW,transfert
12-May-2021,'0NIPG,12-May-2021,10.00,,"109,100.51",COMMISSION 000013210512074538000129121977 NIP TRANSFER COMMISSION FOR 000013210512074538000129121977 via GTWORLD  TO HUSSAINI YUSUF ReF:GW681976569000000012002105120746,SAVINGS ACCOUNT,GT_Bank,./static/raw/MR_IBRAHIM_ASHAFA_STATEMENT.pdf,COMMISSION NIP TRANSFER COMMISSION FOR via GTWORLD TO HUSSAINI YUSUF ReF GW,COMMISSION NIP TRANSFER COMMISSION FOR via GTWORLD TO HUSSAINI YUSUF ReF GW,commission
12-May-2021,'0NIPG,12-May-2021,.75,,"109,099.76",VALUE ADDED TAX 000013210512074538000129121977 VAT ON NIP TRANSFER FOR 000013210512074538000129121977 via GTWORLD  TO HUSSAINI YUSUF ReF:GW681976569000000012002105120746,SAVINGS ACCOUNT,GT_Bank,./static/raw/MR_IBRAHIM_ASHAFA_STATEMENT.pdf,VALUE ADDED TAX VAT ON NIP TRANSFER FOR via GTWORLD TO HUSSAINI YUSUF ReF GW,VALUE ADDED TAX VAT ON NIP TRANSFER FOR via GTWORLD TO HUSSAINI YUSUF ReF GW,tax
12-May-2021,'0NIPG,12-May-2021,"4,000.00",,"105,099.76",NIBSS Instant Payment Outward 000013210512074641000129122340 via GTWORLD  TO YUSUF HASSAN /10.75/REF:GW6819765690000000400021051207  f,SAVINGS ACCOUNT,GT_Bank,./static/raw/MR_IBRAHIM_ASHAFA_STATEMENT.pdf,NIBSS Instant Payment Outward via GTWORLD TO YUSUF HASSAN REF GW f,NIBSS Instant Payment Outward via GTWORLD TO YUSUF HASSAN REF GW,transfert
12-May-2021,'0NIPG,12-May-2021,10.00,,"105,089.76",COMMISSION 000013210512074641000129122340 NIP TRANSFER COMMISSION FOR 000013210512074641000129122340 via GTWORLD  TO YUSUF HASSAN ReF:GW681976569000000040002105120747,SAVINGS ACCOUNT,GT_Bank,./static/raw/MR_IBRAHIM_ASHAFA_STATEMENT.pdf,COMMISSION NIP TRANSFER COMMISSION FOR via GTWORLD TO YUSUF HASSAN ReF GW,COMMISSION NIP TRANSFER COMMISSION FOR via GTWORLD TO YUSUF HASSAN ReF GW,commission
12-May-2021,'0NIPG,12-May-2021,.75,,"105,089.01",VALUE ADDED TAX 000013210512074641000129122340 VAT ON NIP TRANSFER FOR 000013210512074641000129122340 via GTWORLD  TO YUSUF HASSAN ReF:GW681976569000000040002105120747,SAVINGS ACCOUNT,GT_Bank,./static/raw/MR_IBRAHIM_ASHAFA_STATEMENT.pdf,VALUE ADDED TAX VAT ON NIP TRANSFER FOR via GTWORLD TO YUSUF HASSAN ReF GW,VALUE ADDED TAX VAT ON NIP TRANSFER FOR via GTWORLD TO YUSUF HASSAN ReF GW,tax
12-May-2021,'0USGT,12-May-2021,"10,000.00",,"95,089.01","TRANSFER BETWEEN CUSTOMERS Via USSD GTBank Transfer 000000006810976569341031628300000100002021 05121533  from ASHAFA IBRAHIM ABDULLAHI  to MUNDU HAUWA, MOHAMMED",SAVINGS ACCOUNT,GT_Bank,./static/raw/MR_IBRAHIM_ASHAFA_STATEMENT.pdf,TRANSFER BETWEEN CUSTOMERS Via USSD GTBank Transfer from ASHAFA IBRAHIM ABDULLAHI to MUNDU HAUWA MOHAMMED,TRANSFER BETWEEN CUSTOMERS Via USSD GTBank Transfer from ASHAFA IBRAHIM ABDULLAHI to MUNDU HAUWA MOHAMMED,transfert
12-May-2021,'0USGT,12-May-2021,20.00,,"95,069.01","COMMISSION GTBank Transfer Commission : 08038673032 ASHAFA IBRAHIM ABDULLAHI to MUNDU HAUWA, MOHAMMED 00000000681097656934103162830000010000202105121533",SAVINGS ACCOUNT,GT_Bank,./static/raw/MR_IBRAHIM_ASHAFA_STATEMENT.pdf,COMMISSION GTBank Transfer Commission ASHAFA IBRAHIM ABDULLAHI to MUNDU HAUWA MOHAMMED,COMMISSION GTBank Transfer Commission ASHAFA IBRAHIM ABDULLAHI to MUNDU HAUWA MOHAMMED,transfert
12-May-2021,'0USGT,12-May-2021,1.50,,"95,067.51","VALUE ADDED TAX GTBank Transfer VAT : 08038673032 ASHAFA IBRAHIM ABDULLAHI to MUNDU HAUWA, MOHAMMED 000000006810976569341031628300000100002021 05121533",SAVINGS ACCOUNT,GT_Bank,./static/raw/MR_IBRAHIM_ASHAFA_STATEMENT.pdf,VALUE ADDED TAX GTBank Transfer VAT ASHAFA IBRAHIM ABDULLAHI to MUNDU HAUWA MOHAMMED,VALUE ADDED TAX GTBank Transfer VAT ASHAFA IBRAHIM ABDULLAHI to MUNDU HAUWA MOHAMMED,tax
12-May-2021,'0USAT,12-May-2021,900.00,,"94,167.51",Airtime Purchase USSD- 101CT0000000002585269002-2348038673032,SAVINGS ACCOUNT,GT_Bank,./static/raw/MR_IBRAHIM_ASHAFA_STATEMENT.pdf,Airtime Purchase USSD CT,Airtime Purchase USSD CT,utility
12-May-2021,'0GWTR,12-May-2021,"10,000.00",,"84,167.51","TRANSFER BETWEEN CUSTOMERS Via GTWorld REF:681976569000000100002105121937  from ASHAFA IBRAHIM ABDULLAHI  to  SALAMI, ABUBAKAR",SAVINGS ACCOUNT,GT_Bank,./static/raw/MR_IBRAHIM_ASHAFA_STATEMENT.pdf,TRANSFER BETWEEN CUSTOMERS Via GTWorld REF from ASHAFA IBRAHIM ABDULLAHI to SALAMI ABUBAKAR,TRANSFER BETWEEN CUSTOMERS Via GTWorld REF from ASHAFA IBRAHIM ABDULLAHI to SALAMI ABUBAKAR,transfert
12-May-2021,'0USGT,12-May-2021,"2,000.00",,"82,167.51","TRANSFER BETWEEN CUSTOMERS Via USSD GTBank Transfer 000000006810976569325035536700000020002021 05122116  from ASHAFA IBRAHIM ABDULLAHI  to USONKA, ISMAIL VICENT",SAVINGS ACCOUNT,GT_Bank,./static/raw/MR_IBRAHIM_ASHAFA_STATEMENT.pdf,TRANSFER BETWEEN CUSTOMERS Via USSD GTBank Transfer from ASHAFA IBRAHIM ABDULLAHI to USONKA ISMAIL VICENT,TRANSFER BETWEEN CUSTOMERS Via USSD GTBank Transfer from ASHAFA IBRAHIM ABDULLAHI to USONKA ISMAIL VICENT,transfert
12-May-2021,'0USGT,12-May-2021,20.00,,"82,147.51","COMMISSION GTBank Transfer Commission : 08038673032 ASHAFA IBRAHIM ABDULLAHI to USONKA, ISMAIL VICENT 000000006810976569325035536700000020002021 05122116",SAVINGS ACCOUNT,GT_Bank,./static/raw/MR_IBRAHIM_ASHAFA_STATEMENT.pdf,COMMISSION GTBank Transfer Commission ASHAFA IBRAHIM ABDULLAHI to USONKA ISMAIL VICENT,COMMISSION GTBank Transfer Commission ASHAFA IBRAHIM ABDULLAHI to USONKA ISMAIL VICENT,transfert
12-May-2021,'0USGT,12-May-2021,1.50,,"82,146.01","VALUE ADDED TAX GTBank Transfer VAT : 08038673032 ASHAFA IBRAHIM ABDULLAHI to USONKA, ISMAIL VICENT 000000006810976569325035536700000020002021 05122116",SAVINGS ACCOUNT,GT_Bank,./static/raw/MR_IBRAHIM_ASHAFA_STATEMENT.pdf,VALUE ADDED TAX GTBank Transfer VAT ASHAFA IBRAHIM ABDULLAHI to USONKA ISMAIL VICENT,VALUE ADDED TAX GTBank Transfer VAT ASHAFA IBRAHIM ABDULLAHI to USONKA ISMAIL VICENT,tax
12-May-2021,'0NIPU,12-May-2021,"2,000.00",,"80,146.01",NIBSS Instant Payment Outward 000013210512211741000130492329 USSD NIP Transfer from  08038673032  TO HUZAIFA AL- AMIYU IBRAHIM /10.75/REF:000013210512211741000130492329,SAVINGS ACCOUNT,GT_Bank,./static/raw/MR_IBRAHIM_ASHAFA_STATEMENT.pdf,NIBSS Instant Payment Outward USSD NIP Transfer from TO HUZAIFA AL AMIYU IBRAHIM REF,NIBSS Instant Payment Outward USSD NIP Transfer from TO HUZAIFA AL AMIYU IBRAHIM REF,transfert
12-May-2021,'0NIPU,12-May-2021,10.00,,"80,136.01",COMMISSION 000013210512211741000130492329 USSD NIP RECOVERY CHARGE ReF:000013210512211741000130492329,SAVINGS ACCOUNT,GT_Bank,./static/raw/MR_IBRAHIM_ASHAFA_STATEMENT.pdf,COMMISSION USSD NIP RECOVERY CHARGE ReF,COMMISSION USSD NIP RECOVERY CHARGE ReF,transfert
12-May-2021,'0NIPU,12-May-2021,.75,,"80,135.26",VALUE ADDED TAX 000013210512211741000130492329 VAT ON USSD NIP RECOVERY CHARGEReF:000013210512211741000130492329,SAVINGS ACCOUNT,GT_Bank,./static/raw/MR_IBRAHIM_ASHAFA_STATEMENT.pdf,VALUE ADDED TAX VAT ON USSD NIP RECOVERY CHARGEReF,VALUE ADDED TAX VAT ON USSD NIP RECOVERY CHARGEReF,tax
13-May-2021,'0NIPG,13-May-2021,"10,000.00",,"70,135.26",NIBSS Instant Payment Outward 000013210513190154000131648114 via GTWORLD  TO YAKUBU ASHAFA ABDULLAHI /26.875/REF:GW6819765690000001000021051319 f,SAVINGS ACCOUNT,GT_Bank,./static/raw/MR_IBRAHIM_ASHAFA_STATEMENT.pdf,NIBSS Instant Payment Outward via GTWORLD TO YAKUBU ASHAFA ABDULLAHI REF GW f,NIBSS Instant Payment Outward via GTWORLD TO YAKUBU ASHAFA ABDULLAHI REF GW,transfert
13-May-2021,'0NIPG,13-May-2021,25.00,,"70,110.26",COMMISSION 000013210513190154000131648114 NIP TRANSFER COMMISSION FOR 000013210513190154000131648114 via GTWORLD  TO YAKUBU ASHAFA ABDULLAHI ReF:GW681976569000000100002105131902,SAVINGS ACCOUNT,GT_Bank,./static/raw/MR_IBRAHIM_ASHAFA_STATEMENT.pdf,COMMISSION NIP TRANSFER COMMISSION FOR via GTWORLD TO YAKUBU ASHAFA ABDULLAHI ReF GW,COMMISSION NIP TRANSFER COMMISSION FOR via GTWORLD TO YAKUBU ASHAFA ABDULLAHI ReF GW,commission
13-May-2021,'0NIPG,13-May-2021,1.87,,"70,108.39",VALUE ADDED TAX 000013210513190154000131648114 VAT ON NIP TRANSFER FOR 000013210513190154000131648114 via GTWORLD  TO YAKUBU ASHAFA ABDULLAHI ReF:GW681976569000000100002105131902,SAVINGS ACCOUNT,GT_Bank,./static/raw/MR_IBRAHIM_ASHAFA_STATEMENT.pdf,VALUE ADDED TAX VAT ON NIP TRANSFER FOR via GTWORLD TO YAKUBU ASHAFA ABDULLAHI ReF GW,VALUE ADDED TAX VAT ON NIP TRANSFER FOR via GTWORLD TO YAKUBU ASHAFA ABDULLAHI ReF GW,tax
14-May-2021,'0USAT,14-May-2021,"1,000.00",,"69,108.39",Airtime Purchase USSD- 101CT0000000002588928805-2348038673032,SAVINGS ACCOUNT,GT_Bank,./static/raw/MR_IBRAHIM_ASHAFA_STATEMENT.pdf,Airtime Purchase USSD CT,Airtime Purchase USSD CT,utility
14-May-2021,'0NIPG,14-May-2021,"4,000.00",,"65,108.39",NIBSS Instant Payment Outward 000013210514071453000131957098 via GTWORLD  TO YAKUBU ASHAFA ABDULLAHI /10.75/REF:GW6819765690000000400021051407  f,SAVINGS ACCOUNT,GT_Bank,./static/raw/MR_IBRAHIM_ASHAFA_STATEMENT.pdf,NIBSS Instant Payment Outward via GTWORLD TO YAKUBU ASHAFA ABDULLAHI REF GW f,NIBSS Instant Payment Outward via GTWORLD TO YAKUBU ASHAFA ABDULLAHI REF GW,transfert
14-May-2021,'0NIPG,14-May-2021,10.00,,"65,098.39",COMMISSION 000013210514071453000131957098 NIP TRANSFER COMMISSION FOR 000013210514071453000131957098 via GTWORLD  TO YAKUBU ASHAFA ABDULLAHI ReF:GW681976569000000040002105140714,SAVINGS ACCOUNT,GT_Bank,./static/raw/MR_IBRAHIM_ASHAFA_STATEMENT.pdf,COMMISSION NIP TRANSFER COMMISSION FOR via GTWORLD TO YAKUBU ASHAFA ABDULLAHI ReF GW,COMMISSION NIP TRANSFER COMMISSION FOR via GTWORLD TO YAKUBU ASHAFA ABDULLAHI ReF GW,commission
14-May-2021,'0NIPG,14-May-2021,.75,,"65,097.64",VALUE ADDED TAX 000013210514071453000131957098 VAT ON NIP TRANSFER FOR 000013210514071453000131957098 via GTWORLD  TO YAKUBU ASHAFA ABDULLAHI ReF:GW681976569000000040002105140714,SAVINGS ACCOUNT,GT_Bank,./static/raw/MR_IBRAHIM_ASHAFA_STATEMENT.pdf,VALUE ADDED TAX VAT ON NIP TRANSFER FOR via GTWORLD TO YAKUBU ASHAFA ABDULLAHI ReF GW,VALUE ADDED TAX VAT ON NIP TRANSFER FOR via GTWORLD TO YAKUBU ASHAFA ABDULLAHI ReF GW,tax
14-May-2021,'0NIPG,14-May-2021,"5,000.00",,"60,097.64",NIBSS Instant Payment Outward 000013210514071456000131957505 via GTWORLD  TO YUSUF HASSAN /10.75/REF:GW6819765690000000500021051407  f,SAVINGS ACCOUNT,GT_Bank,./static/raw/MR_IBRAHIM_ASHAFA_STATEMENT.pdf,NIBSS Instant Payment Outward via GTWORLD TO YUSUF HASSAN REF GW f,NIBSS Instant Payment Outward via GTWORLD TO YUSUF HASSAN REF GW,transfert
14-May-2021,'0NIPG,14-May-2021.1,10.00,,"60,087.64",COMMISSION 000013210514071456000131957505 NIP TRANSFER COMMISSION FOR 000013210514071456000131957505 via GTWORLD  TO YUSUF HASSAN ReF:GW681976569000000050002105140715,SAVINGS ACCOUNT,GT_Bank,./static/raw/MR_IBRAHIM_ASHAFA_STATEMENT.pdf,COMMISSION NIP TRANSFER COMMISSION FOR via GTWORLD TO YUSUF HASSAN ReF GW,COMMISSION NIP TRANSFER COMMISSION FOR via GTWORLD TO YUSUF HASSAN ReF GW,commission
14-May-2021,'0NIPG,14-May-2021,.75,,"60,086.89",VALUE ADDED TAX 000013210514071456000131957505 VAT ON NIP TRANSFER FOR 000013210514071456000131957505 via GTWORLD  TO YUSUF HASSAN ReF:GW681976569000000050002105140715,SAVINGS ACCOUNT,GT_Bank,./static/raw/MR_IBRAHIM_ASHAFA_STATEMENT.pdf,VALUE ADDED TAX VAT ON NIP TRANSFER FOR via GTWORLD TO YUSUF HASSAN ReF GW,VALUE ADDED TAX VAT ON NIP TRANSFER FOR via GTWORLD TO YUSUF HASSAN ReF GW,tax
14-May-2021,'0NIPG,14-May-2021,"5,000.00",,"55,086.89",NIBSS Instant Payment Outward 000013210514204452000133188759 via GTWORLD  TO ALIYU MUHAMMED RABIU /10.75/REF:GW6819765690000000500021051420  f,SAVINGS ACCOUNT,GT_Bank,./static/raw/MR_IBRAHIM_ASHAFA_STATEMENT.pdf,NIBSS Instant Payment Outward via GTWORLD TO ALIYU MUHAMMED RABIU REF GW f,NIBSS Instant Payment Outward via GTWORLD TO ALIYU MUHAMMED RABIU REF GW,transfert
14-May-2021,'0NIPG,14-May-2021,10.00,,"55,076.89",COMMISSION 000013210514204452000133188759 NIP TRANSFER COMMISSION FOR 000013210514204452000133188759 via GTWORLD  TO ALIYU MUHAMMED RABIU ReF:GW681976569000000050002105142045,SAVINGS ACCOUNT,GT_Bank,./static/raw/MR_IBRAHIM_ASHAFA_STATEMENT.pdf,COMMISSION NIP TRANSFER COMMISSION FOR via GTWORLD TO ALIYU MUHAMMED RABIU ReF GW,COMMISSION NIP TRANSFER COMMISSION FOR via GTWORLD TO ALIYU MUHAMMED RABIU ReF GW,commission
14-May-2021,'0NIPG,14-May-2021,.75,,"55,076.14",VALUE ADDED TAX 000013210514204452000133188759 VAT ON NIP TRANSFER FOR 000013210514204452000133188759 via GTWORLD  TO ALIYU MUHAMMED RABIU ReF:GW681976569000000050002105142045,SAVINGS ACCOUNT,GT_Bank,./static/raw/MR_IBRAHIM_ASHAFA_STATEMENT.pdf,VALUE ADDED TAX VAT ON NIP TRANSFER FOR via GTWORLD TO ALIYU MUHAMMED RABIU ReF GW,VALUE ADDED TAX VAT ON NIP TRANSFER FOR via GTWORLD TO ALIYU MUHAMMED RABIU ReF GW,tax
15-May-2021,'0NIPG,15-May-2021,"5,000.00",,"50,076.14",NIBSS Instant Payment Outward 000013210515063158000133382170 via GTWORLD  TO YUSUF HASSAN /10.75/REF:GW6819765690000000500021051506  f,SAVINGS ACCOUNT,GT_Bank,./static/raw/MR_IBRAHIM_ASHAFA_STATEMENT.pdf,NIBSS Instant Payment Outward via GTWORLD TO YUSUF HASSAN REF GW f,NIBSS Instant Payment Outward via GTWORLD TO YUSUF HASSAN REF GW,transfert
15-May-2021,'0NIPG,15-May-2021,10.00,,"50,066.14",COMMISSION 000013210515063158000133382170 NIP TRANSFER COMMISSION FOR 000013210515063158000133382170 via GTWORLD  TO YUSUF HASSAN ReF:GW681976569000000050002105150632,SAVINGS ACCOUNT,GT_Bank,./static/raw/MR_IBRAHIM_ASHAFA_STATEMENT.pdf,COMMISSION NIP TRANSFER COMMISSION FOR via GTWORLD TO YUSUF HASSAN ReF GW,COMMISSION NIP TRANSFER COMMISSION FOR via GTWORLD TO YUSUF HASSAN ReF GW,commission
15-May-2021,'0NIPG,15-May-2021,.75,,"50,065.39",VALUE ADDED TAX 000013210515063158000133382170 VAT ON NIP TRANSFER FOR 000013210515063158000133382170 viaGTWORLD  TO YUSUF HASSAN ReF:GW681976569000000050002105150632,SAVINGS ACCOUNT,GT_Bank,./static/raw/MR_IBRAHIM_ASHAFA_STATEMENT.pdf,VALUE ADDED TAX VAT ON NIP TRANSFER FOR viaGTWORLD TO YUSUF HASSAN ReF GW,VALUE ADDED TAX VAT ON NIP TRANSFER FOR via GTWORLD TO YUSUF HASSAN ReF GW,tax
15-May-2021,'0NIPU,15-May-2021,"5,000.00",,"45,065.39",NIBSS Instant Payment Outward 000013210515093444000133572504 USSD NIP Transfer from  08038673032  TO AZUATALAM RHODA OLUWAFUNMILOLA /10.75/REF:000013210515093444000133572504,SAVINGS ACCOUNT,GT_Bank,./static/raw/MR_IBRAHIM_ASHAFA_STATEMENT.pdf,NIBSS Instant Payment Outward USSD NIP Transfer from TO AZUATALAM RHODA OLUWAFUNMILOLA REF,NIBSS Instant Payment Outward USSD NIP Transfer from TO AZUATALAM RHODA OLUWAFUNMILOLA REF,transfert
15-May-2021,'0NIPU,15-May-2021,10.00,,"45,055.39",COMMISSION 000013210515093444000133572504 USSD NIP RECOVERY CHARGE ReF:000013210515093444000133572504,SAVINGS ACCOUNT,GT_Bank,./static/raw/MR_IBRAHIM_ASHAFA_STATEMENT.pdf,COMMISSION USSD NIP RECOVERY CHARGE ReF,COMMISSION USSD NIP RECOVERY CHARGE ReF,transfert
15-May-2021,'0NIPU,15-May-2021,.75,,"45,054.64",VALUE ADDED TAX 000013210515093444000133572504 VAT ON USSD NIP RECOVERY CHARGE ReF:000013210515093444000133572504,SAVINGS ACCOUNT,GT_Bank,./static/raw/MR_IBRAHIM_ASHAFA_STATEMENT.pdf,VALUE ADDED TAX VAT ON USSD NIP RECOVERY CHARGE ReF,VALUE ADDED TAX VAT ON USSD NIP RECOVERY CHARGE ReF,tax
15-May-2021,'0USAT,15-May-2021,"1,500.00",,"43,554.64",Airtime Purchase GTWORLD_QL- 101CT0000000002591982738-2348109828886,SAVINGS ACCOUNT,GT_Bank,./static/raw/MR_IBRAHIM_ASHAFA_STATEMENT.pdf,Airtime Purchase GTWORLD_QL CT,Airtime Purchase GTWORLDQL CT,utility
15-May-2021,'0USAT,15-May-2021,400.00,,"43,154.64",Airtime Purchase GTWORLD_QL- 101CT0000000002591983844-2348038673032,SAVINGS ACCOUNT,GT_Bank,./static/raw/MR_IBRAHIM_ASHAFA_STATEMENT.pdf,Airtime Purchase GTWORLD_QL CT,Airtime Purchase GTWORLDQL CT,utility
15-May-2021,'0GWTR,15-May-2021,"5,000.00",,"38,154.64","TRANSFER BETWEEN CUSTOMERS Via GTWorld REF:681976569000000050002105151956  from ASHAFA IBRAHIM ABDULLAHI  to  JIBRIN, SULEIMAN ADAMU",SAVINGS ACCOUNT,GT_Bank,./static/raw/MR_IBRAHIM_ASHAFA_STATEMENT.pdf,TRANSFER BETWEEN CUSTOMERS Via GTWorld REF from ASHAFA IBRAHIM ABDULLAHI to JIBRIN SULEIMAN ADAMU,TRANSFER BETWEEN CUSTOMERS Via GTWorld REF from ASHAFA IBRAHIM ABDULLAHI to JIBRIN SULEIMAN ADAMU,transfert
16-May-2021,'0USAT,16-May-2021,"1,000.00",,"37,154.64",Airtime Purchase GTWORLD_QL- 101CT0000000002593811503-2348038673032,SAVINGS ACCOUNT,GT_Bank,./static/raw/MR_IBRAHIM_ASHAFA_STATEMENT.pdf,Airtime Purchase GTWORLD_QL CT,Airtime Purchase GTWORLDQL CT,utility
16-May-2021,'0USAT,16-May-2021,"1,000.00",,"36,154.64",Airtime Purchase GTWORLD_QL- 101CT0000000002594729813-2348101212569,SAVINGS ACCOUNT,GT_Bank,./static/raw/MR_IBRAHIM_ASHAFA_STATEMENT.pdf,Airtime Purchase GTWORLD_QL CT,Airtime Purchase GTWORLDQL CT,utility
17-May-2021,'0NIPG,17-May-2021,"2,000.00",,"34,154.64",NIBSS Instant Payment Outward 000013210517134246000136362998 via GTWORLD  TO DANSABO ABDULAZEEZ /10.75/REF:GW6819765690000000200021051713  f,SAVINGS ACCOUNT,GT_Bank,./static/raw/MR_IBRAHIM_ASHAFA_STATEMENT.pdf,NIBSS Instant Payment Outward via GTWORLD TO DANSABO ABDULAZEEZ REF GW f,NIBSS Instant Payment Outward via GTWORLD TO DANSABO ABDULAZEEZ REF GW,transfert
17-May-2021,'0NIPG,17-May-2021,10.00,,"34,144.64",COMMISSION 000013210517134246000136362998 NIP TRANSFER COMMISSION FOR 000013210517134246000136362998 via GTWORLD  TO DANSABO ABDULAZEEZ ReF:GW681976569000000020002105171341,SAVINGS ACCOUNT,GT_Bank,./static/raw/MR_IBRAHIM_ASHAFA_STATEMENT.pdf,COMMISSION NIP TRANSFER COMMISSION FOR via GTWORLD TO DANSABO ABDULAZEEZ ReF GW,COMMISSION NIP TRANSFER COMMISSION FOR via GTWORLD TO DANSABO ABDULAZEEZ ReF GW,commission
17-May-2021,'0NIPG,17-May-2021,.75,,"34,143.89",VALUE ADDED TAX 000013210517134246000136362998 VAT ON NIPTRANSFER FOR 000013210517134246000136362998 via GTWORLD  TO DANSABO ABDULAZEEZ ReF:GW681976569000000020002105171341,SAVINGS ACCOUNT,GT_Bank,./static/raw/MR_IBRAHIM_ASHAFA_STATEMENT.pdf,VALUE ADDED TAX VAT ON NIPTRANSFER FOR via GTWORLD TO DANSABO ABDULAZEEZ ReF GW,VALUE ADDED TAX VAT ON NIPTRANSFER FOR via GTWORLD TO DANSABO ABDULAZEEZ ReF GW,tax
17-May-2021,'0GWTR,17-May-2021,"10,000.00",,"24,143.89",TRANSFER BETWEEN CUSTOMERS Via GTWorld REF:681976569000000100002105171918  from ASHAFA IBRAHIM ABDULLAHI  to  OPARA OLUCHUKWU LUCKY,SAVINGS ACCOUNT,GT_Bank,./static/raw/MR_IBRAHIM_ASHAFA_STATEMENT.pdf,TRANSFER BETWEEN CUSTOMERS Via GTWorld REF from ASHAFA IBRAHIM ABDULLAHI to OPARA OLUCHUKWU LUCKY,TRANSFER BETWEEN CUSTOMERS Via GTWorld REF from ASHAFA IBRAHIM ABDULLAHI to OPARA OLUCHUKWU LUCKY,transfert
17-May-2021,'99997730249999,17-May-2021,920.00,,"23,223.89",POS/WEB PURCHASE TRANSACTION  -773024- - 483021-MEYORS PHARMACY AND    FC FCNG,SAVINGS ACCOUNT,GT_Bank,./static/raw/MR_IBRAHIM_ASHAFA_STATEMENT.pdf,POS WEB PURCHASE TRANSACTION MEYORS PHARMACY AND FC FCNG,POS WEB PURCHASE TRANSACTION MEYORS PHARMACY AND FC FCNG,utility
17-May-2021,'202210000,17-May-2021,600.00,,"22,623.89",POS/WEB PURCHASE TRANSACTION  -020221- - 485883-WOW STORES ENTERPRISE  FC LANG,SAVINGS ACCOUNT,GT_Bank,./static/raw/MR_IBRAHIM_ASHAFA_STATEMENT.pdf,POS WEB PURCHASE TRANSACTION WOW STORES ENTERPRISE FC LANG,POS WEB PURCHASE TRANSACTION WOW STORES ENTERPRISE FC LANG,utility
17-May-2021,'0USAT,17-May-2021,300.00,,"22,323.89",Airtime Purchase USSD- 101CT0000000002597812956-2348101212569,SAVINGS ACCOUNT,GT_Bank,./static/raw/MR_IBRAHIM_ASHAFA_STATEMENT.pdf,Airtime Purchase USSD CT,Airtime Purchase USSD CT,utility
17-May-2021,'0USAT,17-May-2021,200.00,,"22,123.89",Airtime Purchase USSD- 101CT0000000002597833446-2348038673032,SAVINGS ACCOUNT,GT_Bank,./static/raw/MR_IBRAHIM_ASHAFA_STATEMENT.pdf,Airtime Purchase USSD CT,Airtime Purchase USSD CT,utility
18-May-2021,'0GWTR,18-May-2021,"3,000.00",,"19,123.89",TRANSFER BETWEEN CUSTOMERS Via GTWorld REF:681976569000000030002105180656  from ASHAFA IBRAHIM ABDULLAHI  to  OPARA OLUCHUKWU LUCKY,SAVINGS ACCOUNT,GT_Bank,./static/raw/MR_IBRAHIM_ASHAFA_STATEMENT.pdf,TRANSFER BETWEEN CUSTOMERS Via GTWorld REF from ASHAFA IBRAHIM ABDULLAHI to OPARA OLUCHUKWU LUCKY,TRANSFER BETWEEN CUSTOMERS Via GTWorld REF from ASHAFA IBRAHIM ABDULLAHI to OPARA OLUCHUKWU LUCKY,transfert
18-May-2021,'0NIPG,18-May-2021,"10,000.00",,"9,123.89",NIBSS Instant Payment Outward 000013210518070810000137277639 via GTWORLD  TO HAPPY EKKI YAKUBU /26.875/REF:GW6819765690000001000021051807 f,SAVINGS ACCOUNT,GT_Bank,./static/raw/MR_IBRAHIM_ASHAFA_STATEMENT.pdf,NIBSS Instant Payment Outward via GTWORLD TO HAPPY EKKI YAKUBU REF GW f,NIBSS Instant Payment Outward via GTWORLD TO HAPPY EKKI YAKUBU REF GW,transfert
18-May-2021,'0NIPG,18-May-2021,25.00,,"9,098.89",COMMISSION 000013210518070810000137277639 NIP TRANSFER COMMISSION FOR 000013210518070810000137277639 via GTWORLD  TO HAPPY EKKI YAKUBU ReF:GW681976569000000100002105180708,SAVINGS ACCOUNT,GT_Bank,./static/raw/MR_IBRAHIM_ASHAFA_STATEMENT.pdf,COMMISSION NIP TRANSFER COMMISSION FOR via GTWORLD TO HAPPY EKKI YAKUBU ReF GW,COMMISSION NIP TRANSFER COMMISSION FOR via GTWORLD TO HAPPY EKKI YAKUBU ReF GW,commission
18-May-2021,'0NIPG,18-May-2021,1.87,,"9,097.02",VALUE ADDED TAX 000013210518070810000137277639 VAT ON NIP TRANSFER FOR 000013210518070810000137277639 via GTWORLD  TO HAPPY EKKI YAKUBU ReF:GW681976569000000100002105180708,SAVINGS ACCOUNT,GT_Bank,./static/raw/MR_IBRAHIM_ASHAFA_STATEMENT.pdf,VALUE ADDED TAX VAT ON NIP TRANSFER FOR via GTWORLD TO HAPPY EKKI YAKUBU ReF GW,VALUE ADDED TAX VAT ON NIP TRANSFER FOR via GTWORLD TO HAPPY EKKI YAKUBU ReF GW,tax
18-May-2021,'99990016819999,18-May-2021.1,"4,100.00",,"4,997.02",POS/WEB PURCHASE TRANSACTION  -001681- - 794422-PAYCOM NIGERIA LIMITED LA LANG,SAVINGS ACCOUNT,GT_Bank,./static/raw/MR_IBRAHIM_ASHAFA_STATEMENT.pdf,POS WEB PURCHASE TRANSACTION PAYCOM NIGERIA LIMITED LA LANG,POS WEB PURCHASE TRANSACTION PAYCOM NIGERIA LIMITED LA LANG,utility
18-May-2021,'0USAT,18-May-2021,800.00,,"4,197.02",Airtime Purchase GTWORLD_QL- 101CT0000000002598311221-2348038673032,SAVINGS ACCOUNT,GT_Bank,./static/raw/MR_IBRAHIM_ASHAFA_STATEMENT.pdf,Airtime Purchase GTWORLD_QL CT,Airtime Purchase GTWORLDQL CT,utility
18-May-2021,'0NIPG,18-May-2021,"3,300.00",,897.02,NIBSS Instant Payment Outward 000013210518200127000138520063 via GTWORLD  TO SULEIMAN ALI BABA /10.75/REF:GW6819765690000000330021051820  f,SAVINGS ACCOUNT,GT_Bank,./static/raw/MR_IBRAHIM_ASHAFA_STATEMENT.pdf,NIBSS Instant Payment Outward via GTWORLD TO SULEIMAN ALI BABA REF GW f,NIBSS Instant Payment Outward via GTWORLD TO SULEIMAN ALI BABA REF GW,transfert
18-May-2021,'0NIPG,18-May-2021,10.00,,887.02,COMMISSION 000013210518200127000138520063 NIP TRANSFER COMMISSION FOR 000013210518200127000138520063 via GTWORLD  TO SULEIMAN ALI BABA ReF:GW681976569000000033002105182001,SAVINGS ACCOUNT,GT_Bank,./static/raw/MR_IBRAHIM_ASHAFA_STATEMENT.pdf,COMMISSION NIP TRANSFER COMMISSION FOR via GTWORLD TO SULEIMAN ALI BABA ReF GW,COMMISSION NIP TRANSFER COMMISSION FOR via GTWORLD TO SULEIMAN ALI BABA ReF GW,commission
18-May-2021,'0NIPG,18-May-2021,.75,,886.27,VALUE ADDED TAX 000013210518200127000138520063 VAT ON NIP TRANSFER FOR 000013210518200127000138520063 via GTWORLD  TO SULEIMAN ALI BABA ReF:GW681976569000000033002105182001,SAVINGS ACCOUNT,GT_Bank,./static/raw/MR_IBRAHIM_ASHAFA_STATEMENT.pdf,VALUE ADDED TAX VAT ON NIP TRANSFER FOR via GTWORLD TO SULEIMAN ALI BABA ReF GW,VALUE ADDED TAX VAT ON NIP TRANSFER FOR via GTWORLD TO SULEIMAN ALI BABA ReF GW,tax
18-May-2021,'0GWTR,18-May-2021,500.00,,386.27,TRANSFER BETWEEN CUSTOMERS Via GTWorld REF:681976569000000005002105182049  from ASHAFA IBRAHIM ABDULLAHI  to  MOHAMMED IBRAHIM,SAVINGS ACCOUNT,GT_Bank,./static/raw/MR_IBRAHIM_ASHAFA_STATEMENT.pdf,TRANSFER BETWEEN CUSTOMERS Via GTWorld REF from ASHAFA IBRAHIM ABDULLAHI to MOHAMMED IBRAHIM,TRANSFER BETWEEN CUSTOMERS Via GTWorld REF from ASHAFA IBRAHIM ABDULLAHI to MOHAMMED IBRAHIM,transfert
19-May-2021,'0USAT,19-May-2021,300.00,,86.27,Airtime Purchase GTWORLD_QL- 101CT0000000002602138982-2348038673032,SAVINGS ACCOUNT,GT_Bank,./static/raw/MR_IBRAHIM_ASHAFA_STATEMENT.pdf,Airtime Purchase GTWORLD_QL CT,Airtime Purchase GTWORLDQL CT,utility
19-May-2021,'0GWTR,19-May-2021,,"10,000.00","10,086.27",TRANSFER BETWEEN CUSTOMERS Via GTWorld Token   REF:396335290000000100002105191838 from UMAR ADAM IBN   to  ASHAFA IBRAHIM ABDULLAHI,SAVINGS ACCOUNT,GT_Bank,./static/raw/MR_IBRAHIM_ASHAFA_STATEMENT.pdf,TRANSFER BETWEEN CUSTOMERS Via GTWorld Token REF from UMAR ADAM IBN to ASHAFA IBRAHIM ABDULLAHI,TRANSFER BETWEEN CUSTOMERS Via GTWorld Token REF from UMAR ADAM IBN to ASHAFA IBRAHIM ABDULLAHI,transfert
19-May-2021,'0NIPG,19-May-2021,"5,000.00",,"5,086.27",NIBSS Instant Payment Outward 000013210519205748000140096260 via GTWORLD  TO YAKUBU ASHAFA ABDULLAHI /10.75/REF:GW6819765690000000500021051920  f,SAVINGS ACCOUNT,GT_Bank,./static/raw/MR_IBRAHIM_ASHAFA_STATEMENT.pdf,NIBSS Instant Payment Outward via GTWORLD TO YAKUBU ASHAFA ABDULLAHI REF GW f,NIBSS Instant Payment Outward via GTWORLD TO YAKUBU ASHAFA ABDULLAHI REF GW,transfert
19-May-2021,'0NIPG,19-May-2021,10.00,,"5,076.27",COMMISSION 000013210519205748000140096260 NIP TRANSFER COMMISSION FOR 000013210519205748000140096260 via GTWORLD  TO YAKUBU ASHAFA ABDULLAHIReF:GW681976569000000050002105192058,SAVINGS ACCOUNT,GT_Bank,./static/raw/MR_IBRAHIM_ASHAFA_STATEMENT.pdf,COMMISSION NIP TRANSFER COMMISSION FOR via GTWORLD TO YAKUBU ASHAFA ABDULLAHIReF GW,COMMISSION NIP TRANSFER COMMISSION FOR via GTWORLD TO YAKUBU ASHAFA ABDULLAHIReF GW,commission
19-May-2021,'0NIPG,19-May-2021,.75,,"5,075.52",VALUE ADDED TAX000013210519205748000140096260 VAT ON NIPTRANSFER FOR000013210519205748000140096260 viaGTWORLD  TO YAKUBU ASHAFA ABDULLAHIReF:GW681976569000000050002105192058,SAVINGS ACCOUNT,GT_Bank,./static/raw/MR_IBRAHIM_ASHAFA_STATEMENT.pdf,VALUE ADDED TAX VAT ON NIPTRANSFER FOR viaGTWORLD TO YAKUBU ASHAFA ABDULLAHIReF GW,VALUE ADDED TAX VAT ON NIPTRANSFER FOR via GTWORLD TO YAKUBU ASHAFA ABDULLAHIReF GW,tax
19-May-2021,'99992604539999,19-May-2021,950.00,,"4,125.52",POS/WEB PURCHASE TRANSACTION  -260453- -569187-SUNDRY FOODS LIMITEDRIRING,SAVINGS ACCOUNT,GT_Bank,./static/raw/MR_IBRAHIM_ASHAFA_STATEMENT.pdf,POS WEB PURCHASE TRANSACTION SUNDRY FOODS LIMITEDRIRING,POS WEB PURCHASE TRANSACTION SUNDRY FOODS LIMITEDRIRING,utility
19-May-2021,'0,19-May-2021,50.00,,"4,075.52",STAMP DUTY CHARGE 19052021 STAMP DUTYCHARGE - 19/05/2021,SAVINGS ACCOUNT,GT_Bank,./static/raw/MR_IBRAHIM_ASHAFA_STATEMENT.pdf,STAMP DUTY CHARGE STAMP DUTYCHARGE,STAMP DUTY CHARGE STAMP DUTYCHARGE,bank_charges
20-May-2021,'0GWTR,20-May-2021,"3,000.00",,"1,075.52","TRANSFER BETWEEN CUSTOMERS Via GTWorldREF:681976569000000030002105201120  fromASHAFA IBRAHIM ABDULLAHI  to  HASSAN,ABDULWAJID BUBA",SAVINGS ACCOUNT,GT_Bank,./static/raw/MR_IBRAHIM_ASHAFA_STATEMENT.pdf,TRANSFER BETWEEN CUSTOMERS Via GTWorldREF fromASHAFA IBRAHIM ABDULLAHI to HASSAN ABDULWAJID BUBA,TRANSFER BETWEEN CUSTOMERS Via GTWorldREF from ASHAFA IBRAHIM ABDULLAHI to HASSAN ABDULWAJID BUBA,transfert
20-May-2021,'0USGT,20-May-2021,,"15,000.00","16,075.52","TRANSFER BETWEEN CUSTOMERS Via USSDGTBank Transfer00000000341031628368109765690000015000202105201345  from MUNDU HAUWA, MOHAMMED  toASHAFA IBRAHIM ABDULLAHI",SAVINGS ACCOUNT,GT_Bank,./static/raw/MR_IBRAHIM_ASHAFA_STATEMENT.pdf,TRANSFER BETWEEN CUSTOMERS Via USSDGTBank Transfer from MUNDU HAUWA MOHAMMED toASHAFA IBRAHIM ABDULLAHI,TRANSFER BETWEEN CUSTOMERS Via USSDGTBank Transfer from MUNDU HAUWA MOHAMMED toASHAFA IBRAHIM ABDULLAHI,transfert
20-May-2021,'0NIPG,20-May-2021,"5,000.00",,"11,075.52",NIBSS Instant Payment Outward000013210520135243000140929069 viaGTWORLD  TO JIBRIL SALEH MAINA/10.75/REF:GW6819765690000000500021052013  f,SAVINGS ACCOUNT,GT_Bank,./static/raw/MR_IBRAHIM_ASHAFA_STATEMENT.pdf,NIBSS Instant Payment Outward viaGTWORLD TO JIBRIL SALEH MAINA REF GW f,NIBSS Instant Payment Outward via GTWORLD TO JIBRIL SALEH MAINA REF GW,transfert
20-May-2021,'0NIPG,20-May-2021,10.00,,"11,065.52",COMMISSION 000013210520135243000140929069NIP TRANSFER COMMISSION FOR000013210520135243000140929069 viaGTWORLD  TO JIBRIL SALEH MAINAReF:GW681976569000000050002105201353,SAVINGS ACCOUNT,GT_Bank,./static/raw/MR_IBRAHIM_ASHAFA_STATEMENT.pdf,COMMISSION NIP TRANSFER COMMISSION FOR viaGTWORLD TO JIBRIL SALEH MAINAReF GW,COMMISSION NIP TRANSFER COMMISSION FOR via GTWORLD TO JIBRIL SALEH MAINAReF GW,commission
20-May-2021,'0NIPG,20-May-2021,.75,,"11,064.77",VALUE ADDED TAX000013210520135243000140929069 VAT ON NIPTRANSFER FOR000013210520135243000140929069 viaGTWORLD  TO JIBRIL SALEH MAINAReF:GW681976569000000050002105201353,SAVINGS ACCOUNT,GT_Bank,./static/raw/MR_IBRAHIM_ASHAFA_STATEMENT.pdf,VALUE ADDED TAX VAT ON NIPTRANSFER FOR viaGTWORLD TO JIBRIL SALEH MAINAReF GW,VALUE ADDED TAX VAT ON NIPTRANSFER FOR via GTWORLD TO JIBRIL SALEH MAINAReF GW,tax
20-May-2021,'0USAT,20-May-2021,900.00,,"10,164.77",Airtime Purchase GTWORLD_QL-101CT0000000002604373004-2348030549818,SAVINGS ACCOUNT,GT_Bank,./static/raw/MR_IBRAHIM_ASHAFA_STATEMENT.pdf,Airtime Purchase GTWORLD_QL CT,Airtime Purchase GTWORLDQL CT,utility
20-May-2021,'0USAT,20-May-2021.1,"1,000.00",,"9,164.77",Airtime Purchase GTWORLD_QL- 101CT0000000002604374479-2348038673032,SAVINGS ACCOUNT,GT_Bank,./static/raw/MR_IBRAHIM_ASHAFA_STATEMENT.pdf,Airtime Purchase GTWORLD_QL CT,Airtime Purchase GTWORLDQL CT,utility
20-May-2021,'0NIPT,20-May-2021,,"20,000.00","29,164.77",TRANSFER BETWEEN CUSTOMERS 000004210520174833001189723143|USSD-NIP/To ASHAFA A./23480XXXX9995|2348038509995/1189723143||A BDULLAHI ASHAFA REF:000004210520174833001189723143,SAVINGS ACCOUNT,GT_Bank,./static/raw/MR_IBRAHIM_ASHAFA_STATEMENT.pdf,TRANSFER BETWEEN CUSTOMERS USSD NIP To ASHAFA A XXXX A BDULLAHI ASHAFA REF,TRANSFER BETWEEN CUSTOMERS USSD NIP To ASHAFAXXXXBDULLAHI ASHAFA REF,transfert
20-May-2021,'99993488619999,20-May-2021,"7,890.50",,"21,274.27",POS/WEB PURCHASE TRANSACTION  -348861- - 298586-BMO CENTRAL PARK ABU   FC FCNG,SAVINGS ACCOUNT,GT_Bank,./static/raw/MR_IBRAHIM_ASHAFA_STATEMENT.pdf,POS WEB PURCHASE TRANSACTION BMO CENTRAL PARK ABU FC FCNG,POS WEB PURCHASE TRANSACTION BMO CENTRAL PARK ABU FC FCNG,utility
20-May-2021,'0NIPG,20-May-2021,"2,000.00",,"19,274.27",NIBSS Instant Payment Outward 000013210520185902000141447068 via GTWORLD  TO YUSUF  SHEHU /10.75/REF:GW6819765690000000200021052018  f,SAVINGS ACCOUNT,GT_Bank,./static/raw/MR_IBRAHIM_ASHAFA_STATEMENT.pdf,NIBSS Instant Payment Outward via GTWORLD TO YUSUF SHEHU REF GW f,NIBSS Instant Payment Outward via GTWORLD TO YUSUF SHEHU REF GW,transfert
20-May-2021,'0NIPG,20-May-2021,10.00,,"19,264.27",COMMISSION 000013210520185902000141447068 NIP TRANSFER COMMISSION FOR 000013210520185902000141447068 via GTWORLD  TO YUSUF  SHEHU ReF:GW681976569000000020002105201858,SAVINGS ACCOUNT,GT_Bank,./static/raw/MR_IBRAHIM_ASHAFA_STATEMENT.pdf,COMMISSION NIP TRANSFER COMMISSION FOR via GTWORLD TO YUSUF SHEHU ReF GW,COMMISSION NIP TRANSFER COMMISSION FOR via GTWORLD TO YUSUF SHEHU ReF GW,commission
20-May-2021,'0NIPG,20-May-2021,.75,,"19,263.52",VALUE ADDED TAX 000013210520185902000141447068 VAT ON NIP TRANSFER FOR 000013210520185902000141447068 via GTWORLD  TO YUSUF  SHEHU ReF:GW681976569000000020002105201858,SAVINGS ACCOUNT,GT_Bank,./static/raw/MR_IBRAHIM_ASHAFA_STATEMENT.pdf,VALUE ADDED TAX VAT ON NIP TRANSFER FOR via GTWORLD TO YUSUF SHEHU ReF GW,VALUE ADDED TAX VAT ON NIP TRANSFER FOR via GTWORLD TO YUSUF SHEHU ReF GW,tax
20-May-2021,'0NIPG,20-May-2021,"10,000.00",,"9,263.52",NIBSS Instant Payment Outward 000013210520195846000141540467 via GTWORLD  TO AISHA NAMAMA ZUBAIRU /26.875/REF:GW6819765690000001000021052019 f,SAVINGS ACCOUNT,GT_Bank,./static/raw/MR_IBRAHIM_ASHAFA_STATEMENT.pdf,NIBSS Instant Payment Outward via GTWORLD TO AISHA NAMAMA ZUBAIRU REF GW f,NIBSS Instant Payment Outward via GTWORLD TO AISHA NAMAMA ZUBAIRU REF GW,transfert
20-May-2021,'0NIPG,20-May-2021,25.00,,"9,238.52",COMMISSION 000013210520195846000141540467 NIP TRANSFER COMMISSION FOR 000013210520195846000141540467 via GTWORLD  TO AISHA NAMAMA ZUBAIRU ReF:GW681976569000000100002105201959,SAVINGS ACCOUNT,GT_Bank,./static/raw/MR_IBRAHIM_ASHAFA_STATEMENT.pdf,COMMISSION NIP TRANSFER COMMISSION FOR via GTWORLD TO AISHA NAMAMA ZUBAIRU ReF GW,COMMISSION NIP TRANSFER COMMISSION FOR via GTWORLD TO AISHA NAMAMA ZUBAIRU ReF GW,commission
20-May-2021,'0NIPG,20-May-2021,1.87,,"9,236.65",VALUE ADDED TAX 000013210520195846000141540467 VAT ON NIPTRANSFER FOR000013210520195846000141540467 viaGTWORLD  TO AISHA NAMAMA ZUBAIRUReF:GW681976569000000100002105201959,SAVINGS ACCOUNT,GT_Bank,./static/raw/MR_IBRAHIM_ASHAFA_STATEMENT.pdf,VALUE ADDED TAX VAT ON NIPTRANSFER FOR viaGTWORLD TO AISHA NAMAMA ZUBAIRUReF GW,VALUE ADDED TAX VAT ON NIPTRANSFER FOR via GTWORLD TO AISHA NAMAMA ZUBAIRUReF GW,tax
20-May-2021,'99991727449999,20-May-2021,"9,000.00",,236.65,CASH WITHDRAWAL FROM OTHER ATM  -172744- -536124-000000000000840 Abuja  WuseNG,SAVINGS ACCOUNT,GT_Bank,./static/raw/MR_IBRAHIM_ASHAFA_STATEMENT.pdf,CASH WITHDRAWAL FROM OTHER ATM Abuja WuseNG,CASH WITHDRAWAL FROM OTHER ATM Abuja WuseNG,cash
21-May-2021,'0,20-May-2021,100.00,,136.65,STAMP DUTY CHARGE 20052021 STAMP DUTYCHARGE - 20/05/2021,SAVINGS ACCOUNT,GT_Bank,./static/raw/MR_IBRAHIM_ASHAFA_STATEMENT.pdf,STAMP DUTY CHARGE STAMP DUTYCHARGE,STAMP DUTY CHARGE STAMP DUTYCHARGE,bank_charges
21-May-2021,'0NIPT,21-May-2021,,"50,000.00","50,136.65",TRANSFER BETWEEN CUSTOMERS000026210521154405000004558006|NIP/TRF IFOASHAFA IBRAHIM ABDULLAHI BO IBRAHIMAS|STAJJNG21052107177800||IBRAHIM ASHAFAREF:000026210521154405000004558006,SAVINGS ACCOUNT,GT_Bank,./static/raw/MR_IBRAHIM_ASHAFA_STATEMENT.pdf,TRANSFER BETWEEN CUSTOMERS NIP TRF IFOASHAFA IBRAHIM ABDULLAHI BO IBRAHIMAS STAJJNG IBRAHIM ASHAFAREF,TRANSFER BETWEEN CUSTOMERS NIP TRF IFOASHAFA IBRAHIM ABDULLAHI BO IBRAHIMAS STAJJNG IBRAHIM ASHAFAREF,transfert
21-May-2021,'0NIPG,21-May-2021,"20,000.00",,"30,136.65",NIBSS Instant Payment Outward000013210521165254000142814861 viaGTWORLD  TO ABDULLAHI ASHAFA/26.875/REF:GW6819765690000002000021052116f,SAVINGS ACCOUNT,GT_Bank,./static/raw/MR_IBRAHIM_ASHAFA_STATEMENT.pdf,NIBSS Instant Payment Outward viaGTWORLD TO ABDULLAHI ASHAFA REF GW f,NIBSS Instant Payment Outward via GTWORLD TO ABDULLAHI ASHAFA REF GW,transfert
21-May-2021,'0NIPG,21-May-2021,25.00,,"30,111.65",COMMISSION 000013210521165254000142814861NIP TRANSFER COMMISSION FOR000013210521165254000142814861 viaGTWORLD  TO ABDULLAHI ASHAFAReF:GW681976569000000200002105211653,SAVINGS ACCOUNT,GT_Bank,./static/raw/MR_IBRAHIM_ASHAFA_STATEMENT.pdf,COMMISSION NIP TRANSFER COMMISSION FOR viaGTWORLD TO ABDULLAHI ASHAFAReF GW,COMMISSION NIP TRANSFER COMMISSION FOR via GTWORLD TO ABDULLAHI ASHAFAReF GW,commission
21-May-2021,'0NIPG,21-May-2021,1.87,,"30,109.78",VALUE ADDED TAX000013210521165254000142814861 VAT ON NIPTRANSFER FOR000013210521165254000142814861 viaGTWORLD  TO ABDULLAHI ASHAFAReF:GW681976569000000200002105211653,SAVINGS ACCOUNT,GT_Bank,./static/raw/MR_IBRAHIM_ASHAFA_STATEMENT.pdf,VALUE ADDED TAX VAT ON NIPTRANSFER FOR viaGTWORLD TO ABDULLAHI ASHAFAReF GW,VALUE ADDED TAX VAT ON NIPTRANSFER FOR via GTWORLD TO ABDULLAHI ASHAFAReF GW,tax
21-May-2021,'0NIPG,21-May-2021,"5,000.00",,"25,109.78",NIBSS Instant Payment Outward000013210521165319000142815489 viaGTWORLD  TO YAKUBU ASHAFA ABDULLAHI/10.75/REF:GW6819765690000000500021052116  f,SAVINGS ACCOUNT,GT_Bank,./static/raw/MR_IBRAHIM_ASHAFA_STATEMENT.pdf,NIBSS Instant Payment Outward viaGTWORLD TO YAKUBU ASHAFA ABDULLAHI REF GW f,NIBSS Instant Payment Outward via GTWORLD TO YAKUBU ASHAFA ABDULLAHI REF GW,transfert
21-May-2021,'0NIPG,21-May-2021,10.00,,"25,099.78",COMMISSION 000013210521165319000142815489NIP TRANSFER COMMISSION FOR000013210521165319000142815489 viaGTWORLD  TO YAKUBU ASHAFA ABDULLAHIReF:GW681976569000000050002105211653,SAVINGS ACCOUNT,GT_Bank,./static/raw/MR_IBRAHIM_ASHAFA_STATEMENT.pdf,COMMISSION NIP TRANSFER COMMISSION FOR viaGTWORLD TO YAKUBU ASHAFA ABDULLAHIReF GW,COMMISSION NIP TRANSFER COMMISSION FOR via GTWORLD TO YAKUBU ASHAFA ABDULLAHIReF GW,commission
21-May-2021,'0NIPG,21-May-2021,.75,,"25,099.03",VALUE ADDED TAX000013210521165319000142815489 VAT ON NIPTRANSFER FOR000013210521165319000142815489 viaGTWORLD  TO YAKUBU ASHAFA ABDULLAHIReF:GW681976569000000050002105211653,SAVINGS ACCOUNT,GT_Bank,./static/raw/MR_IBRAHIM_ASHAFA_STATEMENT.pdf,VALUE ADDED TAX VAT ON NIPTRANSFER FOR viaGTWORLD TO YAKUBU ASHAFA ABDULLAHIReF GW,VALUE ADDED TAX VAT ON NIPTRANSFER FOR via GTWORLD TO YAKUBU ASHAFA ABDULLAHIReF GW,tax
21-May-2021,'0NIPG,21-May-2021,"5,000.00",,"20,099.03",NIBSS Instant Payment Outward000013210521175614000142925860 viaGTWORLD  TO HALIMA TANKO ABUBAKAR/10.75/REF:GW6819765690000000500021052117  f,SAVINGS ACCOUNT,GT_Bank,./static/raw/MR_IBRAHIM_ASHAFA_STATEMENT.pdf,NIBSS Instant Payment Outward viaGTWORLD TO HALIMA TANKO ABUBAKAR REF GW f,NIBSS Instant Payment Outward via GTWORLD TO HALIMA TANKO ABUBAKAR REF GW,transfert
21-May-2021,'0NIPG,21-May-2021,10.00,,"20,089.03",COMMISSION 000013210521175614000142925860NIP TRANSFER COMMISSION FOR000013210521175614000142925860 viaGTWORLD  TO HALIMA TANKO ABUBAKARReF:GW681976569000000050002105211755,SAVINGS ACCOUNT,GT_Bank,./static/raw/MR_IBRAHIM_ASHAFA_STATEMENT.pdf,COMMISSION NIP TRANSFER COMMISSION FOR viaGTWORLD TO HALIMA TANKO ABUBAKARReF GW,COMMISSION NIP TRANSFER COMMISSION FOR via GTWORLD TO HALIMA TANKO ABUBAKARReF GW,commission
21-May-2021,'0NIPG,21-May-2021,.75,,"20,088.28",VALUE ADDED TAX000013210521175614000142925860 VAT ON NIPTRANSFER FOR000013210521175614000142925860 viaGTWORLD  TO HALIMA TANKO ABUBAKARReF:GW681976569000000050002105211755,SAVINGS ACCOUNT,GT_Bank,./static/raw/MR_IBRAHIM_ASHAFA_STATEMENT.pdf,VALUE ADDED TAX VAT ON NIPTRANSFER FOR viaGTWORLD TO HALIMA TANKO ABUBAKARReF GW,VALUE ADDED TAX VAT ON NIPTRANSFER FOR via GTWORLD TO HALIMA TANKO ABUBAKARReF GW,tax
21-May-2021,'0,21-May-2021,50.00,,"20,038.28",STAMP DUTY CHARGE 21052021 STAMP DUTYCHARGE - 21/05/2021,SAVINGS ACCOUNT,GT_Bank,./static/raw/MR_IBRAHIM_ASHAFA_STATEMENT.pdf,STAMP DUTY CHARGE STAMP DUTYCHARGE,STAMP DUTY CHARGE STAMP DUTYCHARGE,bank_charges
22-May-2021,'0USAT,22-May-2021,"1,000.00",,"19,038.28",Airtime Purchase GTWORLD_QL-101CT0000000002608663519-2348038673032,SAVINGS ACCOUNT,GT_Bank,./static/raw/MR_IBRAHIM_ASHAFA_STATEMENT.pdf,Airtime Purchase GTWORLD_QL CT,Airtime Purchase GTWORLDQL CT,utility
22-May-2021,'0GWTR,22-May-2021,,"4,000.00","23,038.28",TRANSFER BETWEEN CUSTOMERS Via GTWorldREF:325345926000000040002105221949  fromRIKKO YILLUWIRI KEREN  to  ASHAFA IBRAHIMABDULLAHI,SAVINGS ACCOUNT,GT_Bank,./static/raw/MR_IBRAHIM_ASHAFA_STATEMENT.pdf,TRANSFER BETWEEN CUSTOMERS Via GTWorldREF fromRIKKO YILLUWIRI KEREN to ASHAFA IBRAHIMABDULLAHI,TRANSFER BETWEEN CUSTOMERS Via GTWorldREF from RIKKO YILLUWIRI KEREN to ASHAFA IBRAHIMABDULLAHI,transfert
22-May-2021,'99991968169999,22-May-2021,"3,000.00",,"20,038.28",CASH WITHDRAWAL FROM OTHER ATM  -196816- -471756-KEYSTONE BANKwuseNG,SAVINGS ACCOUNT,GT_Bank,./static/raw/MR_IBRAHIM_ASHAFA_STATEMENT.pdf,CASH WITHDRAWAL FROM OTHER ATM KEYSTONE BANKwuseNG,CASH WITHDRAWAL FROM OTHER ATM KEYSTONE BANKwuseNG,cash
23-May-2021,'0NIPT,23-May-2021,,"10,000.00","30,038.28",TRANSFER BETWEEN CUSTOMERS000012210523130033000256354041|TRF FRMHAUWA . MUSA|1LKW7YSRK66T8C53||HAUWAMUSAREF:000012210523130033000256354041,SAVINGS ACCOUNT,GT_Bank,./static/raw/MR_IBRAHIM_ASHAFA_STATEMENT.pdf,TRANSFER BETWEEN CUSTOMERS TRF FRMHAUWA MUSA LKW YSRK T C HAUWAMUSAREF,TRANSFER BETWEEN CUSTOMERS TRF FRMHAUWA MUSA LKW YSRKC HAUWAMUSAREF,transfert
23-May-2021,'0NIPG,23-May-2021.1,"2,000.00",,"28,038.28",NIBSS Instant Payment Outward 000013210523164333000145351940 via GTWORLD  TO JOSEPH DRAMABI YOHANNA /10.75/REF:GW6819765690000000200021052316  f,SAVINGS ACCOUNT,GT_Bank,./static/raw/MR_IBRAHIM_ASHAFA_STATEMENT.pdf,NIBSS Instant Payment Outward via GTWORLD TO JOSEPH DRAMABI YOHANNA REF GW f,NIBSS Instant Payment Outward via GTWORLD TO JOSEPH DRAMABI YOHANNA REF GW,transfert
23-May-2021,'0NIPG,23-May-2021,10.00,,"28,028.28",COMMISSION 000013210523164333000145351940 NIP TRANSFER COMMISSION FOR 000013210523164333000145351940 via GTWORLD  TO JOSEPH DRAMABI YOHANNA ReF:GW681976569000000020002105231644,SAVINGS ACCOUNT,GT_Bank,./static/raw/MR_IBRAHIM_ASHAFA_STATEMENT.pdf,COMMISSION NIP TRANSFER COMMISSION FOR via GTWORLD TO JOSEPH DRAMABI YOHANNA ReF GW,COMMISSION NIP TRANSFER COMMISSION FOR via GTWORLD TO JOSEPH DRAMABI YOHANNA ReF GW,commission
23-May-2021,'0NIPG,23-May-2021,.75,,"28,027.53",VALUE ADDED TAX 000013210523164333000145351940 VAT ON NIP TRANSFER FOR 000013210523164333000145351940 via GTWORLD  TO JOSEPH DRAMABI YOHANNA ReF:GW681976569000000020002105231644,SAVINGS ACCOUNT,GT_Bank,./static/raw/MR_IBRAHIM_ASHAFA_STATEMENT.pdf,VALUE ADDED TAX VAT ON NIP TRANSFER FOR via GTWORLD TO JOSEPH DRAMABI YOHANNA ReF GW,VALUE ADDED TAX VAT ON NIP TRANSFER FOR via GTWORLD TO JOSEPH DRAMABI YOHANNA ReF GW,tax
23-May-2021,'0NIPG,23-May-2021,"1,500.00",,"26,527.53",NIBSS Instant Payment Outward 000013210523183823000145486276 via GTWORLD  TO YAKUBU ASHAFA ABDULLAHI /10.75/REF:GW6819765690000000150021052318  f,SAVINGS ACCOUNT,GT_Bank,./static/raw/MR_IBRAHIM_ASHAFA_STATEMENT.pdf,NIBSS Instant Payment Outward via GTWORLD TO YAKUBU ASHAFA ABDULLAHI REF GW f,NIBSS Instant Payment Outward via GTWORLD TO YAKUBU ASHAFA ABDULLAHI REF GW,transfert
23-May-2021,'0NIPG,23-May-2021,10.00,,"26,517.53",COMMISSION 000013210523183823000145486276 NIP TRANSFER COMMISSION FOR 000013210523183823000145486276 via GTWORLD  TO YAKUBU ASHAFA ABDULLAHI ReF:GW681976569000000015002105231838,SAVINGS ACCOUNT,GT_Bank,./static/raw/MR_IBRAHIM_ASHAFA_STATEMENT.pdf,COMMISSION NIP TRANSFER COMMISSION FOR via GTWORLD TO YAKUBU ASHAFA ABDULLAHI ReF GW,COMMISSION NIP TRANSFER COMMISSION FOR via GTWORLD TO YAKUBU ASHAFA ABDULLAHI ReF GW,commission
23-May-2021,'0NIPG,23-May-2021,.75,,"26,516.78",VALUE ADDED TAX 000013210523183823000145486276 VAT ON NIP TRANSFER FOR 000013210523183823000145486276 via GTWORLD  TO YAKUBU ASHAFA ABDULLAHI ReF:GW681976569000000015002105231838,SAVINGS ACCOUNT,GT_Bank,./static/raw/MR_IBRAHIM_ASHAFA_STATEMENT.pdf,VALUE ADDED TAX VAT ON NIP TRANSFER FOR via GTWORLD TO YAKUBU ASHAFA ABDULLAHI ReF GW,VALUE ADDED TAX VAT ON NIP TRANSFER FOR via GTWORLD TO YAKUBU ASHAFA ABDULLAHI ReF GW,tax
23-May-2021,'0USAT,23-May-2021,"1,200.00",,"25,316.78",Airtime Purchase GTWORLD- 101CT0000000002611669519-2348038673032,SAVINGS ACCOUNT,GT_Bank,./static/raw/MR_IBRAHIM_ASHAFA_STATEMENT.pdf,Airtime Purchase GTWORLD CT,Airtime Purchase GTWORLD CT,utility
23-May-2021,'0,23-May-2021,50.00,,"25,266.78",STAMP DUTY CHARGE 23052021 STAMP DUTY CHARGE - 23/05/2021,SAVINGS ACCOUNT,GT_Bank,./static/raw/MR_IBRAHIM_ASHAFA_STATEMENT.pdf,STAMP DUTY CHARGE STAMP DUTY CHARGE,STAMP DUTY CHARGE STAMP DUTY CHARGE,bank_charges
24-May-2021,'99990093759999,24-May-2021,"5,100.00",,"20,166.78",FUNDS TRANSFER  -009375- -426225-T009375 2TGT1393       LA           LANG,SAVINGS ACCOUNT,GT_Bank,./static/raw/MR_IBRAHIM_ASHAFA_STATEMENT.pdf,FUNDS TRANSFER T TGT LA LANG,FUNDS TRANSFERTGT LA LANG,utility
24-May-2021,'0NIPG,24-May-2021,"6,500.00",,"13,666.78",NIBSS Instant Payment Outward 000013210524122209000146326589 viaGTWORLD  TO BEPOS CLINIC AND MATERNITY/26.875/REF:GW6819765690000000650021052412f,SAVINGS ACCOUNT,GT_Bank,./static/raw/MR_IBRAHIM_ASHAFA_STATEMENT.pdf,NIBSS Instant Payment Outward viaGTWORLD TO BEPOS CLINIC AND MATERNITY REF GW f,NIBSS Instant Payment Outward via GTWORLD TO BEPOS CLINIC AND MATERNITY REF GW,transfert
24-May-2021,'0NIPG,24-May-2021,25.00,,"13,641.78",COMMISSION 000013210524122209000146326589NIP TRANSFER COMMISSION FOR000013210524122209000146326589 viaGTWORLD  TO BEPOS CLINIC AND MATERNITYReF:GW681976569000000065002105241222,SAVINGS ACCOUNT,GT_Bank,./static/raw/MR_IBRAHIM_ASHAFA_STATEMENT.pdf,COMMISSION NIP TRANSFER COMMISSION FOR viaGTWORLD TO BEPOS CLINIC AND MATERNITYReF GW,COMMISSION NIP TRANSFER COMMISSION FOR via GTWORLD TO BEPOS CLINIC AND MATERNITYReF GW,commission
24-May-2021,'0NIPG,24-May-2021,1.87,,"13,639.91",VALUE ADDED TAX000013210524122209000146326589 VAT ON NIPTRANSFER FOR000013210524122209000146326589 viaGTWORLD  TO BEPOS CLINIC AND MATERNITYReF:GW681976569000000065002105241222,SAVINGS ACCOUNT,GT_Bank,./static/raw/MR_IBRAHIM_ASHAFA_STATEMENT.pdf,VALUE ADDED TAX VAT ON NIPTRANSFER FOR viaGTWORLD TO BEPOS CLINIC AND MATERNITYReF GW,VALUE ADDED TAX VAT ON NIPTRANSFER FOR via GTWORLD TO BEPOS CLINIC AND MATERNITYReF GW,tax
24-May-2021,'99991887689999,24-May-2021,"7,000.00",,"6,639.91",POS/WEB PURCHASE TRANSACTION  -188768- -219881-OANDO FILLING STATIOFCFCNG,SAVINGS ACCOUNT,GT_Bank,./static/raw/MR_IBRAHIM_ASHAFA_STATEMENT.pdf,POS WEB PURCHASE TRANSACTION OANDO FILLING STATIOFCFCNG,POS WEB PURCHASE TRANSACTION OANDO FILLING STATIOFCFCNG,utility
24-May-2021,'0USAT,24-May-2021,"1,400.00",,"5,239.91",Airtime Purchase GTWORLD-101CT0000000002614601020-2348038673032,SAVINGS ACCOUNT,GT_Bank,./static/raw/MR_IBRAHIM_ASHAFA_STATEMENT.pdf,Airtime Purchase GTWORLD CT,Airtime Purchase GTWORLD CT,utility
24-May-2021,'260,24-May-2021,440.00,,"4,799.91",SMS ALERT CHARGE FOR 23APR2021-20MAY2021,SAVINGS ACCOUNT,GT_Bank,./static/raw/MR_IBRAHIM_ASHAFA_STATEMENT.pdf,SMS ALERT CHARGE FOR APR MAY,SMS ALERT CHARGE FOR APR MAY,loan
25-May-2021,'0NIPG,25-May-2021,"4,000.00",,799.91,NIBSS Instant Payment Outward000013210525113545000147850102 viaGTWORLD  TO YAKUBU ASHAFA ABDULLAHI/10.75/REF:GW6819765690000000400021052511  f,SAVINGS ACCOUNT,GT_Bank,./static/raw/MR_IBRAHIM_ASHAFA_STATEMENT.pdf,NIBSS Instant Payment Outward viaGTWORLD TO YAKUBU ASHAFA ABDULLAHI REF GW f,NIBSS Instant Payment Outward via GTWORLD TO YAKUBU ASHAFA ABDULLAHI REF GW,transfert
25-May-2021,'0NIPG,25-May-2021,10.00,,789.91,COMMISSION 000013210525113545000147850102NIP TRANSFER COMMISSION FOR000013210525113545000147850102 viaGTWORLD  TO YAKUBU ASHAFA ABDULLAHIReF:GW681976569000000040002105251135,SAVINGS ACCOUNT,GT_Bank,./static/raw/MR_IBRAHIM_ASHAFA_STATEMENT.pdf,COMMISSION NIP TRANSFER COMMISSION FOR viaGTWORLD TO YAKUBU ASHAFA ABDULLAHIReF GW,COMMISSION NIP TRANSFER COMMISSION FOR via GTWORLD TO YAKUBU ASHAFA ABDULLAHIReF GW,commission
25-May-2021,'0NIPG,25-May-2021,.75,,789.16,VALUE ADDED TAX000013210525113545000147850102 VAT ON NIPTRANSFER FOR000013210525113545000147850102 viaGTWORLD  TO YAKUBU ASHAFA ABDULLAHIReF:GW681976569000000040002105251135,SAVINGS ACCOUNT,GT_Bank,./static/raw/MR_IBRAHIM_ASHAFA_STATEMENT.pdf,VALUE ADDED TAX VAT ON NIPTRANSFER FOR viaGTWORLD TO YAKUBU ASHAFA ABDULLAHIReF GW,VALUE ADDED TAX VAT ON NIPTRANSFER FOR via GTWORLD TO YAKUBU ASHAFA ABDULLAHIReF GW,tax
25-May-2021,'0NIPT,25-May-2021,,"10,000.00","10,789.16",TRANSFER BETWEEN CUSTOMERS000015210525133127001745906861|.|457825968||IBIYE JAMES NYINGIEREFAKAREF:000015210525133127001745906861,SAVINGS ACCOUNT,GT_Bank,./static/raw/MR_IBRAHIM_ASHAFA_STATEMENT.pdf,TRANSFER BETWEEN CUSTOMERS IBIYE JAMES NYINGIEREFAKAREF,TRANSFER BETWEEN CUSTOMERS IBIYE JAMES NYINGIEREFAKAREF,transfert
25-May-2021,'0NIPG,25-May-2021,"4,500.00",,"6,289.16",NIBSS Instant Payment Outward000013210525145508000148210791 viaGTWORLD  TO YAKUBU ASHAFA ABDULLAHI/10.75/REF:GW6819765690000000450021052514  f,SAVINGS ACCOUNT,GT_Bank,./static/raw/MR_IBRAHIM_ASHAFA_STATEMENT.pdf,NIBSS Instant Payment Outward viaGTWORLD TO YAKUBU ASHAFA ABDULLAHI REF GW f,NIBSS Instant Payment Outward via GTWORLD TO YAKUBU ASHAFA ABDULLAHI REF GW,transfert
25-May-2021,'0NIPG,25-May-2021,10.00,,"6,279.16",COMMISSION 000013210525145508000148210791NIP TRANSFER COMMISSION FOR000013210525145508000148210791 viaGTWORLD  TO YAKUBU ASHAFA ABDULLAHIReF:GW681976569000000045002105251455,SAVINGS ACCOUNT,GT_Bank,./static/raw/MR_IBRAHIM_ASHAFA_STATEMENT.pdf,COMMISSION NIP TRANSFER COMMISSION FOR viaGTWORLD TO YAKUBU ASHAFA ABDULLAHIReF GW,COMMISSION NIP TRANSFER COMMISSION FOR via GTWORLD TO YAKUBU ASHAFA ABDULLAHIReF GW,commission
25-May-2021,'0NIPG,25-May-2021,.75,,"6,278.41",VALUE ADDED TAX000013210525145508000148210791 VAT ON NIPTRANSFER FOR000013210525145508000148210791 viaGTWORLD  TO YAKUBU ASHAFA ABDULLAHIReF:GW681976569000000045002105251455,SAVINGS ACCOUNT,GT_Bank,./static/raw/MR_IBRAHIM_ASHAFA_STATEMENT.pdf,VALUE ADDED TAX VAT ON NIPTRANSFER FOR viaGTWORLD TO YAKUBU ASHAFA ABDULLAHIReF GW,VALUE ADDED TAX VAT ON NIPTRANSFER FOR via GTWORLD TO YAKUBU ASHAFA ABDULLAHIReF GW,tax
26-May-2021,'0,25-May-2021,50.00,,"6,228.41",STAMP DUTY CHARGE 25052021 STAMP DUTYCHARGE - 25/05/2021,SAVINGS ACCOUNT,GT_Bank,./static/raw/MR_IBRAHIM_ASHAFA_STATEMENT.pdf,STAMP DUTY CHARGE STAMP DUTYCHARGE,STAMP DUTY CHARGE STAMP DUTYCHARGE,bank_charges
26-May-2021,'0NIPG,26-May-2021,"4,000.00",,"2,228.41",NIBSS Instant Payment Outward000013210526102623000149380851 viaGTWORLD  TO ABDULLAHI  ASHAFA/10.75/REF:GW6819765690000000400021052610  f,SAVINGS ACCOUNT,GT_Bank,./static/raw/MR_IBRAHIM_ASHAFA_STATEMENT.pdf,NIBSS Instant Payment Outward viaGTWORLD TO ABDULLAHI ASHAFA REF GW f,NIBSS Instant Payment Outward via GTWORLD TO ABDULLAHI ASHAFA REF GW,transfert
26-May-2021,'0NIPG,26-May-2021,10.00,,"2,218.41",COMMISSION 000013210526102623000149380851NIP TRANSFER COMMISSION FOR000013210526102623000149380851 viaGTWORLD  TO ABDULLAHI  ASHAFAReF:GW681976569000000040002105261026,SAVINGS ACCOUNT,GT_Bank,./static/raw/MR_IBRAHIM_ASHAFA_STATEMENT.pdf,COMMISSION NIP TRANSFER COMMISSION FOR viaGTWORLD TO ABDULLAHI ASHAFAReF GW,COMMISSION NIP TRANSFER COMMISSION FOR via GTWORLD TO ABDULLAHI ASHAFAReF GW,commission
26-May-2021,'0NIPG,26-May-2021,.75,,"2,217.66",VALUE ADDED TAX000013210526102623000149380851 VAT ON NIPTRANSFER FOR000013210526102623000149380851 viaGTWORLD  TO ABDULLAHI  ASHAFAReF:GW681976569000000040002105261026,SAVINGS ACCOUNT,GT_Bank,./static/raw/MR_IBRAHIM_ASHAFA_STATEMENT.pdf,VALUE ADDED TAX VAT ON NIPTRANSFER FOR viaGTWORLD TO ABDULLAHI ASHAFAReF GW,VALUE ADDED TAX VAT ON NIPTRANSFER FOR via GTWORLD TO ABDULLAHI ASHAFAReF GW,tax
26-May-2021,'0GWTR,26-May-2021,"2,000.00",,217.66,TRANSFER BETWEEN CUSTOMERS Via GTWorldREF:681976569000000020002105261702  fromASHAFA IBRAHIM ABDULLAHI  to  NWEKETRINITY OLUNKA,SAVINGS ACCOUNT,GT_Bank,./static/raw/MR_IBRAHIM_ASHAFA_STATEMENT.pdf,TRANSFER BETWEEN CUSTOMERS Via GTWorldREF fromASHAFA IBRAHIM ABDULLAHI to NWEKETRINITY OLUNKA,TRANSFER BETWEEN CUSTOMERS Via GTWorldREF from ASHAFA IBRAHIM ABDULLAHI to NWEKETRINITY OLUNKA,transfert
27-May-2021,'0USGT,27-May-2021,,"10,000.00","10,217.66","TRANSFER BETWEEN CUSTOMERS Via USSDGTBank Transfer00000000328044186768109765690000010000202105271337  from IGE-RAPHAEL, OLUWATOYIN  toASHAFA IBRAHIM ABDULLAHI",SAVINGS ACCOUNT,GT_Bank,./static/raw/MR_IBRAHIM_ASHAFA_STATEMENT.pdf,TRANSFER BETWEEN CUSTOMERS Via USSDGTBank Transfer from IGE RAPHAEL OLUWATOYIN toASHAFA IBRAHIM ABDULLAHI,TRANSFER BETWEEN CUSTOMERS Via USSDGTBank Transfer from IGE RAPHAEL OLUWATOYIN toASHAFA IBRAHIM ABDULLAHI,transfert
27-May-2021,'179820000,27-May-2021,"5,000.00",,"5,217.66",POS/WEB PURCHASE TRANSACTION  -017982- -029772-SHEMA PETROLEUM LIMITEDKDLANG,SAVINGS ACCOUNT,GT_Bank,./static/raw/MR_IBRAHIM_ASHAFA_STATEMENT.pdf,POS WEB PURCHASE TRANSACTION SHEMA PETROLEUM LIMITEDKDLANG,POS WEB PURCHASE TRANSACTION SHEMA PETROLEUM LIMITEDKDLANG,utility
28-May-2021,'0NIPT,28-May-2021,,"2,000.00","7,217.66",TRANSFER BETWEEN CUSTOMERS000010210528170720111315447300|REF752574342 BO abdullahi ibrahim IFO ASHAFAIBRA|752574342||abdullahi ibrahimREF:000010210528170720111315447300,SAVINGS ACCOUNT,GT_Bank,./static/raw/MR_IBRAHIM_ASHAFA_STATEMENT.pdf,TRANSFER BETWEEN CUSTOMERS REF BO abdullahi ibrahim IFO ASHAFAIBRA abdullahi ibrahimREF,TRANSFER BETWEEN CUSTOMERS REF BO abdullahi ibrahim IFO ASHAFAIBRA abdullahi ibrahimREF,transfert
28-May-2021,'99997375039999,28-May-2021,"2,000.00",,"5,217.66",CASH WITHDRAWAL FROM OTHER ATM  -737503- -213267-000000000011404 Abuja  WuseNG,SAVINGS ACCOUNT,GT_Bank,./static/raw/MR_IBRAHIM_ASHAFA_STATEMENT.pdf,CASH WITHDRAWAL FROM OTHER ATM Abuja WuseNG,CASH WITHDRAWAL FROM OTHER ATM Abuja WuseNG,cash
28-May-2021,'0USGT,28-May-2021,,"5,000.00","10,217.66","TRANSFER BETWEEN CUSTOMERS Via USSDGTBank Transfer00000000541053673468109765690000005000202105282009  from OBALISA, KUNLE OLUWABUKOLAto  ASHAFA IBRAHIM ABDULLAHI",SAVINGS ACCOUNT,GT_Bank,./static/raw/MR_IBRAHIM_ASHAFA_STATEMENT.pdf,TRANSFER BETWEEN CUSTOMERS Via USSDGTBank Transfer from OBALISA KUNLE OLUWABUKOLAto ASHAFA IBRAHIM ABDULLAHI,TRANSFER BETWEEN CUSTOMERS Via USSDGTBank Transfer from OBALISA KUNLE OLUWABUKOLAto ASHAFA IBRAHIM ABDULLAHI,transfert
28-May-2021,'0NIPG,28-May-2021,"3,000.00",,"7,217.66",NIBSS Instant Payment Outward000013210528204539000153937183 viaGTWORLD  TO OGBUKA IFEOMA ROSE/10.75/REF:GW6819765690000000300021052820  f,SAVINGS ACCOUNT,GT_Bank,./static/raw/MR_IBRAHIM_ASHAFA_STATEMENT.pdf,NIBSS Instant Payment Outward viaGTWORLD TO OGBUKA IFEOMA ROSE REF GW f,NIBSS Instant Payment Outward via GTWORLD TO OGBUKA IFEOMA ROSE REF GW,transfert
28-May-2021,'0NIPG,28-May-2021,10.00,,"7,207.66",COMMISSION 000013210528204539000153937183NIP TRANSFER COMMISSION FOR000013210528204539000153937183 viaGTWORLD  TO OGBUKA IFEOMA ROSEReF:GW681976569000000030002105282046,SAVINGS ACCOUNT,GT_Bank,./static/raw/MR_IBRAHIM_ASHAFA_STATEMENT.pdf,COMMISSION NIP TRANSFER COMMISSION FOR viaGTWORLD TO OGBUKA IFEOMA ROSEReF GW,COMMISSION NIP TRANSFER COMMISSION FOR via GTWORLD TO OGBUKA IFEOMA ROSEReF GW,commission
28-May-2021,'0NIPG,28-May-2021,.75,,"7,206.91",VALUE ADDED TAX000013210528204539000153937183 VAT ON NIPTRANSFER FOR000013210528204539000153937183 viaGTWORLD  TO OGBUKA IFEOMA ROSEReF:GW681976569000000030002105282046,SAVINGS ACCOUNT,GT_Bank,./static/raw/MR_IBRAHIM_ASHAFA_STATEMENT.pdf,VALUE ADDED TAX VAT ON NIPTRANSFER FOR viaGTWORLD TO OGBUKA IFEOMA ROSEReF GW,VALUE ADDED TAX VAT ON NIPTRANSFER FOR via GTWORLD TO OGBUKA IFEOMA ROSEReF GW,tax
31-May-2021,'0NIPT,31-May-2021,,"20,000.00","27,206.91",TRANSFER BETWEEN CUSTOMERS100033210531165724000007092379|Palmpay -ABDULHAKEEMNASIR|100033210531165724000007092379||PALM PAY LIMITED REF:100033210531165724000007092379,SAVINGS ACCOUNT,GT_Bank,./static/raw/MR_IBRAHIM_ASHAFA_STATEMENT.pdf,TRANSFER BETWEEN CUSTOMERS Palmpay ABDULHAKEEMNASIR PALM PAY LIMITED REF,TRANSFER BETWEEN CUSTOMERS Palmpay ABDULHAKEEMNASIR PALM PAY LIMITED REF,transfert
31-May-2021,'0GWTR,31-May-2021,"5,000.00",,"22,206.91",TRANSFER BETWEEN CUSTOMERS Via GTWorld REF:681976569000000050002105311858  from ASHAFA IBRAHIM ABDULLAHI  to  IDEHEN NAOMI IKPONMWOSA,SAVINGS ACCOUNT,GT_Bank,./static/raw/MR_IBRAHIM_ASHAFA_STATEMENT.pdf,TRANSFER BETWEEN CUSTOMERS Via GTWorld REF from ASHAFA IBRAHIM ABDULLAHI to IDEHEN NAOMI IKPONMWOSA,TRANSFER BETWEEN CUSTOMERS Via GTWorld REF from ASHAFA IBRAHIM ABDULLAHI to IDEHEN NAOMI IKPONMWOSA,transfert
31-May-2021,'0NIPG,31-May-2021,"10,000.00",,"12,206.91",NIBSS Instant Payment Outward 000013210531185939000158243574 via GTWORLD Your allowance TO HALIMA TANKO ABUBAKAR /26.875/REF:GW6819765690000001000021053119 f,SAVINGS ACCOUNT,GT_Bank,./static/raw/MR_IBRAHIM_ASHAFA_STATEMENT.pdf,NIBSS Instant Payment Outward via GTWORLD Your allowance TO HALIMA TANKO ABUBAKAR REF GW f,NIBSS Instant Payment Outward via GTWORLD Your allowance TO HALIMA TANKO ABUBAKAR REF GW,transfert
31-May-2021,'0NIPG,31-May-2021,25.00,,"12,181.91",COMMISSION 000013210531185939000158243574 NIP TRANSFER COMMISSION FOR 000013210531185939000158243574 via GTWORLD Your allowance TO HALIMA TANKO ABUBAKAR ReF:GW681976569000000100002105311900,SAVINGS ACCOUNT,GT_Bank,./static/raw/MR_IBRAHIM_ASHAFA_STATEMENT.pdf,COMMISSION NIP TRANSFER COMMISSION FOR via GTWORLD Your allowance TO HALIMA TANKO ABUBAKAR ReF GW,COMMISSION NIP TRANSFER COMMISSION FOR via GTWORLD Your allowance TO HALIMA TANKO ABUBAKAR ReF GW,commission
31-May-2021,'0NIPG,31-May-2021,1.87,,"12,180.04",VALUE ADDED TAX 000013210531185939000158243574 VAT ON NIP TRANSFER FOR 000013210531185939000158243574 via GTWORLD Your allowance TO HALIMA TANKO ABUBAKAR ReF:GW681976569000000100002105311900,SAVINGS ACCOUNT,GT_Bank,./static/raw/MR_IBRAHIM_ASHAFA_STATEMENT.pdf,VALUE ADDED TAX VAT ON NIP TRANSFER FOR via GTWORLD Your allowance TO HALIMA TANKO ABUBAKAR ReF GW,VALUE ADDED TAX VAT ON NIP TRANSFER FOR via GTWORLD Your allowance TO HALIMA TANKO ABUBAKAR ReF GW,tax
31-May-2021,'0NIPG,31-May-2021,"10,000.00",,"2,180.04",FAILED NIBSS INSTANT PAYMENT 000013210531192542000158288788 via GTWORLD  TO AISHA NAMAMA ZUBAIRU /26.875/REF:GW6819765690000001000021053119 f,SAVINGS ACCOUNT,GT_Bank,./static/raw/MR_IBRAHIM_ASHAFA_STATEMENT.pdf,FAILED NIBSS INSTANT PAYMENT via GTWORLD TO AISHA NAMAMA ZUBAIRU REF GW f,FAILED NIBSS INSTANT PAYMENT via GTWORLD TO AISHA NAMAMA ZUBAIRU REF GW,transfert
31-May-2021,'0NIPG,31-May-2021,25.00,,"2,155.04",COMMISSION 000013210531192542000158288788 NIP TRANSFER COMMISSION FOR 000013210531192542000158288788 via GTWORLD  TO AISHA NAMAMA ZUBAIRU ReF:GW681976569000000100002105311926,SAVINGS ACCOUNT,GT_Bank,./static/raw/MR_IBRAHIM_ASHAFA_STATEMENT.pdf,COMMISSION NIP TRANSFER COMMISSION FOR via GTWORLD TO AISHA NAMAMA ZUBAIRU ReF GW,COMMISSION NIP TRANSFER COMMISSION FOR via GTWORLD TO AISHA NAMAMA ZUBAIRU ReF GW,commission
31-May-2021,'0NIPG,31-May-2021,1.87,,"2,153.17",VALUE ADDED TAX 000013210531192542000158288788 VAT ON NIP TRANSFER FOR000013210531192542000158288788 via GTWORLD  TO AISHA NAMAMA ZUBAIRU ReF:GW681976569000000100002105311926,SAVINGS ACCOUNT,GT_Bank,./static/raw/MR_IBRAHIM_ASHAFA_STATEMENT.pdf,VALUE ADDED TAX VAT ON NIP TRANSFER FOR via GTWORLD TO AISHA NAMAMA ZUBAIRU ReF GW,VALUE ADDED TAX VAT ON NIP TRANSFER FOR via GTWORLD TO AISHA NAMAMA ZUBAIRU ReF GW,tax
31-May-2021,'0USAT,31-May-2021,900.00,,"1,253.17",Airtime Purchase GTWORLD- 101CT0000000002632337925-2348030549818,SAVINGS ACCOUNT,GT_Bank,./static/raw/MR_IBRAHIM_ASHAFA_STATEMENT.pdf,Airtime Purchase GTWORLD CT,Airtime Purchase GTWORLD CT,utility
31-May-2021,'0USAT,31-May-2021,"1,000.00",,253.17,Airtime Purchase GTWORLD- 101CT0000000002632339567-2348038673032,SAVINGS ACCOUNT,GT_Bank,./static/raw/MR_IBRAHIM_ASHAFA_STATEMENT.pdf,Airtime Purchase GTWORLD CT,Airtime Purchase GTWORLD CT,utility
31-May-2021,'0,31-May-2021,50.00,,203.17,STAMP DUTY CHARGE 31052021 STAMP DUTY CHARGE - 31/05/2021,SAVINGS ACCOUNT,GT_Bank,./static/raw/MR_IBRAHIM_ASHAFA_STATEMENT.pdf,STAMP DUTY CHARGE STAMP DUTY CHARGE,STAMP DUTY CHARGE STAMP DUTY CHARGE,bank_charges
01-Jun-2021,'41200012077,31-May-2021,"26,529.45",,"-26,326.28",MATURED LOAN INSTALLMENT,SAVINGS ACCOUNT,GT_Bank,./static/raw/MR_IBRAHIM_ASHAFA_STATEMENT.pdf,MATURED LOAN INSTALLMENT,MATURED LOAN INSTALLMENT,loan
01-Jun-2021,'0,31-May-2021,60.84,,"-26,387.12",INTEREST CAPITALISED,SAVINGS ACCOUNT,GT_Bank,./static/raw/MR_IBRAHIM_ASHAFA_STATEMENT.pdf,INTEREST CAPITALISED,INTEREST CAPITALISED,loan
01-Jun-2021,'0NIPR,01-Jun-2021,,"10,000.00","-16,387.12",FAILED NIBSS INSTANT PAYMENT 000013210531192542000158288788 NIP Reversal: Failure From Beneficiary Bank REF:000013210531192542000158288788,SAVINGS ACCOUNT,GT_Bank,./static/raw/MR_IBRAHIM_ASHAFA_STATEMENT.pdf,FAILED NIBSS INSTANT PAYMENT NIP Reversal Failure From Beneficiary Bank REF,FAILED NIBSS INSTANT PAYMENT NIP Reversal Failure From Beneficiary Bank REF,reversal
01-Jun-2021,'00,01-Jun-2021,,25.00,"-16,362.12",FAILED NIBSS INSTANT PAYMENT 000013210531192542000158288788 NIP Reversal: Failure From Beneficiary Bank REF:000013210531192542000158288788,SAVINGS ACCOUNT,GT_Bank,./static/raw/MR_IBRAHIM_ASHAFA_STATEMENT.pdf,FAILED NIBSS INSTANT PAYMENT NIP Reversal Failure From Beneficiary Bank REF,FAILED NIBSS INSTANT PAYMENT NIP Reversal Failure From Beneficiary Bank REF,reversal
02-Jun-2021,'0NIPT,02-Jun-2021,,"20,000.00","3,637.88",TRANSFER BETWEEN CUSTOMERS 100033210602092319000007192965|Palmpay - ABDULHAKEEM NASIR|100033210602092319000007192965||PALM PAY LIMITED REF:100033210602092319000007192965,SAVINGS ACCOUNT,GT_Bank,./static/raw/MR_IBRAHIM_ASHAFA_STATEMENT.pdf,TRANSFER BETWEEN CUSTOMERS Palmpay ABDULHAKEEM NASIR PALM PAY LIMITED REF,TRANSFER BETWEEN CUSTOMERS Palmpay ABDULHAKEEM NASIR PALM PAY LIMITED REF,transfert
02-Jun-2021,'0USAT,02-Jun-2021,500.00,,"3,137.88",Airtime Purchase GTWORLD_QL- 101CT0000000002636804795-2348030549818,SAVINGS ACCOUNT,GT_Bank,./static/raw/MR_IBRAHIM_ASHAFA_STATEMENT.pdf,Airtime Purchase GTWORLD_QL CT,Airtime Purchase GTWORLDQL CT,utility
02-Jun-2021,'0USAT,02-Jun-2021,500.00,,"2,637.88",Airtime Purchase GTWORLD_QL- 101CT0000000002636807133-2348105511466,SAVINGS ACCOUNT,GT_Bank,./static/raw/MR_IBRAHIM_ASHAFA_STATEMENT.pdf,Airtime Purchase GTWORLD_QL CT,Airtime Purchase GTWORLDQL CT,utility
02-Jun-2021,'0USAT,02-Jun-2021,"1,000.00",,"1,637.88",Airtime Purchase GTWORLD_QL- 101CT0000000002636809034-2348038673032,SAVINGS ACCOUNT,GT_Bank,./static/raw/MR_IBRAHIM_ASHAFA_STATEMENT.pdf,Airtime Purchase GTWORLD_QL CT,Airtime Purchase GTWORLDQL CT,utility
02-Jun-2021,'0NIPT,02-Jun-2021,,400.00,"2,037.88",TRANSFER BETWEEN CUSTOMERS 000010210602121348111279439352|REF75773109 3 BO abdullahi ibrahim IFO ASHAFA IBRA|757731093||abdullahi ibrahim REF:000010210602121348111279439352,SAVINGS ACCOUNT,GT_Bank,./static/raw/MR_IBRAHIM_ASHAFA_STATEMENT.pdf,TRANSFER BETWEEN CUSTOMERS REF BO abdullahi ibrahim IFO ASHAFA IBRA abdullahi ibrahim REF,TRANSFER BETWEEN CUSTOMERS REF BO abdullahi ibrahim IFO ASHAFA IBRA abdullahi ibrahim REF,transfert
02-Jun-2021,'0USAT,02-Jun-2021.1,800.00,,"1,237.88",Airtime Purchase GTWORLD_QL- 101CT0000000002636819537-2348109828886,SAVINGS ACCOUNT,GT_Bank,./static/raw/MR_IBRAHIM_ASHAFA_STATEMENT.pdf,Airtime Purchase GTWORLD_QL CT,Airtime Purchase GTWORLDQL CT,utility
02-Jun-2021,'0NIPT,02-Jun-2021,,"100,000.00","101,237.88",TRANSFER BETWEEN CUSTOMERS 000026210602164456000004801708|NIP/BO IBRAHIM ASHAFA|STAJJNG21060207489693||IBRAHIM ASHAFA REF:000026210602164456000004801708,SAVINGS ACCOUNT,GT_Bank,./static/raw/MR_IBRAHIM_ASHAFA_STATEMENT.pdf,TRANSFER BETWEEN CUSTOMERS NIP BO IBRAHIM ASHAFA STAJJNG IBRAHIM ASHAFA REF,TRANSFER BETWEEN CUSTOMERS NIP BO IBRAHIM ASHAFA STAJJNG IBRAHIM ASHAFA REF,transfert
02-Jun-2021,'0GWTR,02-Jun-2021,"70,000.00",,"31,237.88",TRANSFER BETWEEN CUSTOMERS Via GTWorld House rent REF:681976569000000700002106021715  from ASHAFA IBRAHIM ABDULLAHI  to  SANYA EASY ZAKKA,SAVINGS ACCOUNT,GT_Bank,./static/raw/MR_IBRAHIM_ASHAFA_STATEMENT.pdf,TRANSFER BETWEEN CUSTOMERS Via GTWorld House rent REF from ASHAFA IBRAHIM ABDULLAHI to SANYA EASY ZAKKA,TRANSFER BETWEEN CUSTOMERS Via GTWorld House rent REF from ASHAFA IBRAHIM ABDULLAHI to SANYA EASY ZAKKA,transfert
02-Jun-2021,'0NIPG,02-Jun-2021,"4,000.00",,"27,237.88",NIBSS Instant Payment Outward 000013210602174952000161738744 via GTWORLD  TO YAKUBU ASHAFA ABDULLAHI /10.75/REF:GW6819765690000000400021060217  f,SAVINGS ACCOUNT,GT_Bank,./static/raw/MR_IBRAHIM_ASHAFA_STATEMENT.pdf,NIBSS Instant Payment Outward via GTWORLD TO YAKUBU ASHAFA ABDULLAHI REF GW f,NIBSS Instant Payment Outward via GTWORLD TO YAKUBU ASHAFA ABDULLAHI REF GW,transfert
02-Jun-2021,'0NIPG,02-Jun-2021,10.00,,"27,227.88",COMMISSION 000013210602174952000161738744 NIP TRANSFER COMMISSION FOR 000013210602174952000161738744 via GTWORLD  TO YAKUBU ASHAFA ABDULLAHI ReF:GW681976569000000040002106021748,SAVINGS ACCOUNT,GT_Bank,./static/raw/MR_IBRAHIM_ASHAFA_STATEMENT.pdf,COMMISSION NIP TRANSFER COMMISSION FOR via GTWORLD TO YAKUBU ASHAFA ABDULLAHI ReF GW,COMMISSION NIP TRANSFER COMMISSION FOR via GTWORLD TO YAKUBU ASHAFA ABDULLAHI ReF GW,commission
02-Jun-2021,'0NIPG,02-Jun-2021,.75,,"27,227.13",VALUE ADDED TAX 000013210602174952000161738744 VAT ON NIP TRANSFER FOR 000013210602174952000161738744 via GTWORLD  TO YAKUBU ASHAFA ABDULLAHI ReF:GW681976569000000040002106021748,SAVINGS ACCOUNT,GT_Bank,./static/raw/MR_IBRAHIM_ASHAFA_STATEMENT.pdf,VALUE ADDED TAX VAT ON NIP TRANSFER FOR via GTWORLD TO YAKUBU ASHAFA ABDULLAHI ReF GW,VALUE ADDED TAX VAT ON NIP TRANSFER FOR via GTWORLD TO YAKUBU ASHAFA ABDULLAHI ReF GW,tax
02-Jun-2021,'0NIPG,02-Jun-2021,"10,000.00",,"17,227.13",FAILED NIBSS INSTANT PAYMENT 000013210602174926000161742014 via GTWORLD  TO AISHA NAMAMA ZUBAIRU /26.875/REF:GW6819765690000001000021060217 f,SAVINGS ACCOUNT,GT_Bank,./static/raw/MR_IBRAHIM_ASHAFA_STATEMENT.pdf,FAILED NIBSS INSTANT PAYMENT via GTWORLD TO AISHA NAMAMA ZUBAIRU REF GW f,FAILED NIBSS INSTANT PAYMENT via GTWORLD TO AISHA NAMAMA ZUBAIRU REF GW,transfert
02-Jun-2021,'0NIPG,02-Jun-2021,25.00,,"17,202.13",COMMISSION 000013210602174926000161742014 NIP TRANSFER COMMISSION FOR 000013210602174926000161742014 via GTWORLD  TO AISHA NAMAMA ZUBAIRU ReF:GW681976569000000100002106021750,SAVINGS ACCOUNT,GT_Bank,./static/raw/MR_IBRAHIM_ASHAFA_STATEMENT.pdf,COMMISSION NIP TRANSFER COMMISSION FOR via GTWORLD TO AISHA NAMAMA ZUBAIRU ReF GW,COMMISSION NIP TRANSFER COMMISSION FOR via GTWORLD TO AISHA NAMAMA ZUBAIRU ReF GW,commission
02-Jun-2021,'0NIPG,02-Jun-2021.1,1.87,,"17,200.26",VALUE ADDED TAX 000013210602174926000161742014 VAT ON NIP TRANSFER FOR 000013210602174926000161742014 via GTWORLD  TO AISHA NAMAMA ZUBAIRU ReF:GW681976569000000100002106021750,SAVINGS ACCOUNT,GT_Bank,./static/raw/MR_IBRAHIM_ASHAFA_STATEMENT.pdf,VALUE ADDED TAX VAT ON NIP TRANSFER FOR via GTWORLD TO AISHA NAMAMA ZUBAIRU ReF GW,VALUE ADDED TAX VAT ON NIP TRANSFER FOR via GTWORLD TO AISHA NAMAMA ZUBAIRU ReF GW,tax
02-Jun-2021,'0NIPR,02-Jun-2021,,"10,000.00","27,200.26",FAILED NIBSS INSTANT PAYMENT 000013210602174926000161742014 NIP Reversal: Failure From Beneficiary Bank REF:000013210602174926000161742014,SAVINGS ACCOUNT,GT_Bank,./static/raw/MR_IBRAHIM_ASHAFA_STATEMENT.pdf,FAILED NIBSS INSTANT PAYMENT NIP Reversal Failure From Beneficiary Bank REF,FAILED NIBSS INSTANT PAYMENT NIP Reversal Failure From Beneficiary Bank REF,reversal
02-Jun-2021,'00,02-Jun-2021,,25.00,"27,225.26",FAILED NIBSS INSTANT PAYMENT 000013210602174926000161742014 NIP Reversal: Failure From Beneficiary Bank REF:000013210602174926000161742014,SAVINGS ACCOUNT,GT_Bank,./static/raw/MR_IBRAHIM_ASHAFA_STATEMENT.pdf,FAILED NIBSS INSTANT PAYMENT NIP Reversal Failure From Beneficiary Bank REF,FAILED NIBSS INSTANT PAYMENT NIP Reversal Failure From Beneficiary Bank REF,reversal
02-Jun-2021,'00,02-Jun-2021,,1.87,"27,227.13",FAILED NIBSS INSTANT PAYMENT 000013210602174926000161742014 NIP Reversal: Failure From Beneficiary Bank REF:000013210602174926000161742014,SAVINGS ACCOUNT,GT_Bank,./static/raw/MR_IBRAHIM_ASHAFA_STATEMENT.pdf,FAILED NIBSS INSTANT PAYMENT NIP Reversal Failure From Beneficiary Bank REF,FAILED NIBSS INSTANT PAYMENT NIP Reversal Failure From Beneficiary Bank REF,reversal
02-Jun-2021,'0NIPG,02-Jun-2021,"10,000.00",,"17,227.13",NIBSS Instant Payment Outward 000013210602184958000161870251 via GTWORLD  TO AISHA NAMAMA ZUBAIRU /26.875/REF:GW6819765690000001000021060218 f,SAVINGS ACCOUNT,GT_Bank,./static/raw/MR_IBRAHIM_ASHAFA_STATEMENT.pdf,NIBSS Instant Payment Outward via GTWORLD TO AISHA NAMAMA ZUBAIRU REF GW f,NIBSS Instant Payment Outward via GTWORLD TO AISHA NAMAMA ZUBAIRU REF GW,transfert
02-Jun-2021,'0NIPG,02-Jun-2021,25.00,,"17,202.13",COMMISSION 000013210602184958000161870251 NIP TRANSFER COMMISSION FOR 000013210602184958000161870251 via GTWORLD  TO AISHA NAMAMA ZUBAIRU ReF:GW681976569000000100002106021850,SAVINGS ACCOUNT,GT_Bank,./static/raw/MR_IBRAHIM_ASHAFA_STATEMENT.pdf,COMMISSION NIP TRANSFER COMMISSION FOR via GTWORLD TO AISHA NAMAMA ZUBAIRU ReF GW,COMMISSION NIP TRANSFER COMMISSION FOR via GTWORLD TO AISHA NAMAMA ZUBAIRU ReF GW,commission
02-Jun-2021,'0NIPG,02-Jun-2021,1.87,,"17,200.26",VALUE ADDED TAX 000013210602184958000161870251 VAT ON NIP TRANSFER FOR 000013210602184958000161870251 via GTWORLD  TO AISHA NAMAMA ZUBAIRU ReF:GW681976569000000100002106021850,SAVINGS ACCOUNT,GT_Bank,./static/raw/MR_IBRAHIM_ASHAFA_STATEMENT.pdf,VALUE ADDED TAX VAT ON NIP TRANSFER FOR via GTWORLD TO AISHA NAMAMA ZUBAIRU ReF GW,VALUE ADDED TAX VAT ON NIP TRANSFER FOR via GTWORLD TO AISHA NAMAMA ZUBAIRU ReF GW,tax
02-Jun-2021,'0NIPG,02-Jun-2021,"3,000.00",,"14,200.26",NIBSS Instant Payment Outward 000013210602190815000161906176 via GTWORLD  TO OGBUKA IFEOMA ROSE /10.75/REF:GW6819765690000000300021060219  f,SAVINGS ACCOUNT,GT_Bank,./static/raw/MR_IBRAHIM_ASHAFA_STATEMENT.pdf,NIBSS Instant Payment Outward via GTWORLD TO OGBUKA IFEOMA ROSE REF GW f,NIBSS Instant Payment Outward via GTWORLD TO OGBUKA IFEOMA ROSE REF GW,transfert
02-Jun-2021,'0NIPG,02-Jun-2021.1,10.00,,"14,190.26",COMMISSION 000013210602190815000161906176 NIP TRANSFER COMMISSION FOR 000013210602190815000161906176 via GTWORLD  TO OGBUKA IFEOMA ROSE ReF:GW681976569000000030002106021908,SAVINGS ACCOUNT,GT_Bank,./static/raw/MR_IBRAHIM_ASHAFA_STATEMENT.pdf,COMMISSION NIP TRANSFER COMMISSION FOR via GTWORLD TO OGBUKA IFEOMA ROSE ReF GW,COMMISSION NIP TRANSFER COMMISSION FOR via GTWORLD TO OGBUKA IFEOMA ROSE ReF GW,commission
02-Jun-2021,'0NIPG,02-Jun-2021,.75,,"14,189.51",VALUE ADDED TAX 000013210602190815000161906176 VAT ON NIP TRANSFER FOR 000013210602190815000161906176 via GTWORLD  TO OGBUKA IFEOMA ROSE ReF:GW681976569000000030002106021908,SAVINGS ACCOUNT,GT_Bank,./static/raw/MR_IBRAHIM_ASHAFA_STATEMENT.pdf,VALUE ADDED TAX VAT ON NIP TRANSFER FOR via GTWORLD TO OGBUKA IFEOMA ROSE ReF GW,VALUE ADDED TAX VAT ON NIP TRANSFER FOR via GTWORLD TO OGBUKA IFEOMA ROSE ReF GW,tax
02-Jun-2021,'4952590000,02-Jun-2021,"8,000.00",,"6,189.51",POS/WEB PURCHASE TRANSACTION  -495259- - 929547-SHEMA PETROLEUM LIMI   KD KDNG,SAVINGS ACCOUNT,GT_Bank,./static/raw/MR_IBRAHIM_ASHAFA_STATEMENT.pdf,POS WEB PURCHASE TRANSACTION SHEMA PETROLEUM LIMI KD KDNG,POS WEB PURCHASE TRANSACTION SHEMA PETROLEUM LIMI KD KDNG,utility
02-Jun-2021,'0,02-Jun-2021,100.00,,"6,089.51",STAMP DUTY CHARGE 02062021 STAMP DUTY CHARGE - 02/06/2021,SAVINGS ACCOUNT,GT_Bank,./static/raw/MR_IBRAHIM_ASHAFA_STATEMENT.pdf,STAMP DUTY CHARGE STAMP DUTY CHARGE,STAMP DUTY CHARGE STAMP DUTY CHARGE,bank_charges
03-Jun-2021,'0GWTR,03-Jun-2021,"5,500.00",,589.51,TRANSFER BETWEEN CUSTOMERS Via GTWorld REF:681976569000000055002106030905  from ASHAFA IBRAHIM ABDULLAHI  to  IDAKWO ATTAH DANIEL,SAVINGS ACCOUNT,GT_Bank,./static/raw/MR_IBRAHIM_ASHAFA_STATEMENT.pdf,TRANSFER BETWEEN CUSTOMERS Via GTWorld REF from ASHAFA IBRAHIM ABDULLAHI to IDAKWO ATTAH DANIEL,TRANSFER BETWEEN CUSTOMERS Via GTWorld REF from ASHAFA IBRAHIM ABDULLAHI to IDAKWO ATTAH DANIEL,transfert
03-Jun-2021,'0USAT,03-Jun-2021,500.00,,89.51,Airtime Purchase GTWORLD_QL- 101CT0000000002641195654-2348038673032,SAVINGS ACCOUNT,GT_Bank,./static/raw/MR_IBRAHIM_ASHAFA_STATEMENT.pdf,Airtime Purchase GTWORLD_QL CT,Airtime Purchase GTWORLDQL CT,utility
04-Jun-2021,'0NIPT,04-Jun-2021,,"10,000.00","10,089.51",TRANSFER BETWEEN CUSTOMERS 000004210604123537001218153789|USSD-NIP/To ASHAFA A./23480XXXX9995|2348038509995/1218153789||A BDULLAHI ASHAFA REF:000004210604123537001218153789,SAVINGS ACCOUNT,GT_Bank,./static/raw/MR_IBRAHIM_ASHAFA_STATEMENT.pdf,TRANSFER BETWEEN CUSTOMERS USSD NIP To ASHAFA A XXXX A BDULLAHI ASHAFA REF,TRANSFER BETWEEN CUSTOMERS USSD NIP To ASHAFAXXXXBDULLAHI ASHAFA REF,transfert
04-Jun-2021,'0NIPG,04-Jun-2021,"3,000.00",,"7,089.51",NIBSS Instant Payment Outward 000013210604123924000164716236 via GTWORLD  TO SALISU MUHAMMAD ALIYU /10.75/REF:GW6819765690000000300021060412  f,SAVINGS ACCOUNT,GT_Bank,./static/raw/MR_IBRAHIM_ASHAFA_STATEMENT.pdf,NIBSS Instant Payment Outward via GTWORLD TO SALISU MUHAMMAD ALIYU REF GW f,NIBSS Instant Payment Outward via GTWORLD TO SALISU MUHAMMAD ALIYU REF GW,transfert
04-Jun-2021,'0NIPG,04-Jun-2021,10.00,,"7,079.51",COMMISSION 000013210604123924000164716236 NIP TRANSFER COMMISSION FOR 000013210604123924000164716236 via GTWORLD  TO SALISU MUHAMMAD ALIYU ReF:GW681976569000000030002106041240,SAVINGS ACCOUNT,GT_Bank,./static/raw/MR_IBRAHIM_ASHAFA_STATEMENT.pdf,COMMISSION NIP TRANSFER COMMISSION FOR via GTWORLD TO SALISU MUHAMMAD ALIYU ReF GW,COMMISSION NIP TRANSFER COMMISSION FOR via GTWORLD TO SALISU MUHAMMAD ALIYU ReF GW,commission
04-Jun-2021,'0NIPG,04-Jun-2021,.75,,"7,078.76",VALUE ADDED TAX000013210604123924000164716236 VAT ON NIPTRANSFER FOR000013210604123924000164716236 viaGTWORLD  TO SALISU MUHAMMAD ALIYUReF:GW681976569000000030002106041240,SAVINGS ACCOUNT,GT_Bank,./static/raw/MR_IBRAHIM_ASHAFA_STATEMENT.pdf,VALUE ADDED TAX VAT ON NIPTRANSFER FOR viaGTWORLD TO SALISU MUHAMMAD ALIYUReF GW,VALUE ADDED TAX VAT ON NIPTRANSFER FOR via GTWORLD TO SALISU MUHAMMAD ALIYUReF GW,tax
04-Jun-2021,'0NIPT,04-Jun-2021,,"110,004.94","117,083.70",TRANSFER BETWEEN CUSTOMERS000004210604125240200103450417|TUDIBG/UTO/NetC May Sal Ashafa|200103450417||NETCONSTRUCT NIGERIA LIMITEDREF:000004210604125240200103450417,SAVINGS ACCOUNT,GT_Bank,./static/raw/MR_IBRAHIM_ASHAFA_STATEMENT.pdf,TRANSFER BETWEEN CUSTOMERS TUDIBG UTO NetC May Sal Ashafa NETCONSTRUCT NIGERIA LIMITEDREF,TRANSFER BETWEEN CUSTOMERS TUDIBG UTO NetC May Sal Ashafa NETCONSTRUCT NIGERIA LIMITEDREF,transfert
04-Jun-2021,'0NIPG,04-Jun-2021,"50,000.00",,"67,083.70",NIBSS Instant Payment Outward000013210604132322000164797797 viaGTWORLD  TO DEMIDE ENEYAMIRE JEMILATU/26.875/REF:GW6819765690000005000021060413f,SAVINGS ACCOUNT,GT_Bank,./static/raw/MR_IBRAHIM_ASHAFA_STATEMENT.pdf,NIBSS Instant Payment Outward viaGTWORLD TO DEMIDE ENEYAMIRE JEMILATU REF GW f,NIBSS Instant Payment Outward via GTWORLD TO DEMIDE ENEYAMIRE JEMILATU REF GW,transfert
04-Jun-2021,'0NIPG,04-Jun-2021,25.00,,"67,058.70",COMMISSION 000013210604132322000164797797NIP TRANSFER COMMISSION FOR000013210604132322000164797797 viaGTWORLD  TO DEMIDE ENEYAMIRE JEMILATUReF:GW681976569000000500002106041323,SAVINGS ACCOUNT,GT_Bank,./static/raw/MR_IBRAHIM_ASHAFA_STATEMENT.pdf,COMMISSION NIP TRANSFER COMMISSION FOR viaGTWORLD TO DEMIDE ENEYAMIRE JEMILATUReF GW,COMMISSION NIP TRANSFER COMMISSION FOR via GTWORLD TO DEMIDE ENEYAMIRE JEMILATUReF GW,commission
04-Jun-2021,'0NIPG,04-Jun-2021,1.87,,"67,056.83",VALUE ADDED TAX000013210604132322000164797797 VAT ON NIPTRANSFER FOR000013210604132322000164797797 viaGTWORLD  TO DEMIDE ENEYAMIRE JEMILATUReF:GW681976569000000500002106041323,SAVINGS ACCOUNT,GT_Bank,./static/raw/MR_IBRAHIM_ASHAFA_STATEMENT.pdf,VALUE ADDED TAX VAT ON NIPTRANSFER FOR viaGTWORLD TO DEMIDE ENEYAMIRE JEMILATUReF GW,VALUE ADDED TAX VAT ON NIPTRANSFER FOR via GTWORLD TO DEMIDE ENEYAMIRE JEMILATUReF GW,tax
04-Jun-2021,'0NIPG,04-Jun-2021,"10,000.00",,"57,056.83",NIBSS Instant Payment Outward000013210604132531000164803419 viaGTWORLD  TO AISHA NAMAMA ZUBAIRU/26.875/REF:GW6819765690000001000021060413f,SAVINGS ACCOUNT,GT_Bank,./static/raw/MR_IBRAHIM_ASHAFA_STATEMENT.pdf,NIBSS Instant Payment Outward viaGTWORLD TO AISHA NAMAMA ZUBAIRU REF GW f,NIBSS Instant Payment Outward via GTWORLD TO AISHA NAMAMA ZUBAIRU REF GW,transfert
04-Jun-2021,'0NIPG,04-Jun-2021,25.00,,"57,031.83",COMMISSION 000013210604132531000164803419NIP TRANSFER COMMISSION FOR000013210604132531000164803419 viaGTWORLD  TO AISHA NAMAMA ZUBAIRUReF:GW681976569000000100002106041326,SAVINGS ACCOUNT,GT_Bank,./static/raw/MR_IBRAHIM_ASHAFA_STATEMENT.pdf,COMMISSION NIP TRANSFER COMMISSION FOR viaGTWORLD TO AISHA NAMAMA ZUBAIRUReF GW,COMMISSION NIP TRANSFER COMMISSION FOR via GTWORLD TO AISHA NAMAMA ZUBAIRUReF GW,commission
04-Jun-2021,'0NIPG,04-Jun-2021,1.87,,"57,029.96",VALUE ADDED TAX000013210604132531000164803419 VAT ON NIPTRANSFER FOR000013210604132531000164803419 via GTWORLD  TO AISHA NAMAMA ZUBAIRU ReF:GW681976569000000100002106041326,SAVINGS ACCOUNT,GT_Bank,./static/raw/MR_IBRAHIM_ASHAFA_STATEMENT.pdf,VALUE ADDED TAX VAT ON NIPTRANSFER FOR via GTWORLD TO AISHA NAMAMA ZUBAIRU ReF GW,VALUE ADDED TAX VAT ON NIPTRANSFER FOR via GTWORLD TO AISHA NAMAMA ZUBAIRU ReF GW,tax
04-Jun-2021,'0NIPG,04-Jun-2021,"15,000.00",,"42,029.96",NIBSS Instant Payment Outward 000013210604132716000164805228 via GTWORLD  TO YUSUF HASSAN /26.875/REF:GW6819765690000001500021060413 f,SAVINGS ACCOUNT,GT_Bank,./static/raw/MR_IBRAHIM_ASHAFA_STATEMENT.pdf,NIBSS Instant Payment Outward via GTWORLD TO YUSUF HASSAN REF GW f,NIBSS Instant Payment Outward via GTWORLD TO YUSUF HASSAN REF GW,transfert
04-Jun-2021,'0NIPG,04-Jun-2021,25.00,,"42,004.96",COMMISSION 000013210604132716000164805228 NIP TRANSFER COMMISSION FOR 000013210604132716000164805228 via GTWORLD  TO YUSUF HASSAN ReF:GW681976569000000150002106041327,SAVINGS ACCOUNT,GT_Bank,./static/raw/MR_IBRAHIM_ASHAFA_STATEMENT.pdf,COMMISSION NIP TRANSFER COMMISSION FOR via GTWORLD TO YUSUF HASSAN ReF GW,COMMISSION NIP TRANSFER COMMISSION FOR via GTWORLD TO YUSUF HASSAN ReF GW,commission
04-Jun-2021,'0NIPG,04-Jun-2021,1.87,,"42,003.09",VALUE ADDED TAX 000013210604132716000164805228 VAT ON NIP TRANSFER FOR 000013210604132716000164805228 via GTWORLD  TO YUSUF HASSAN ReF:GW681976569000000150002106041327,SAVINGS ACCOUNT,GT_Bank,./static/raw/MR_IBRAHIM_ASHAFA_STATEMENT.pdf,VALUE ADDED TAX VAT ON NIP TRANSFER FOR via GTWORLD TO YUSUF HASSAN ReF GW,VALUE ADDED TAX VAT ON NIP TRANSFER FOR via GTWORLD TO YUSUF HASSAN ReF GW,tax
04-Jun-2021,'0USAT,04-Jun-2021,900.00,,"41,103.09",Airtime Purchase GTWORLD_QL- 101CT0000000002642375135-2348025737027,SAVINGS ACCOUNT,GT_Bank,./static/raw/MR_IBRAHIM_ASHAFA_STATEMENT.pdf,Airtime Purchase GTWORLD_QL CT,Airtime Purchase GTWORLDQL CT,utility
04-Jun-2021,'0USAT,04-Jun-2021,900.00,,"40,203.09",Airtime Purchase GTWORLD_QL- 101CT0000000002642376605-2348030549818,SAVINGS ACCOUNT,GT_Bank,./static/raw/MR_IBRAHIM_ASHAFA_STATEMENT.pdf,Airtime Purchase GTWORLD_QL CT,Airtime Purchase GTWORLDQL CT,utility
04-Jun-2021,'0USAT,04-Jun-2021,"1,000.00",,"39,203.09",Airtime Purchase GTWORLD_QL- 101CT0000000002642379568-2348109828886,SAVINGS ACCOUNT,GT_Bank,./static/raw/MR_IBRAHIM_ASHAFA_STATEMENT.pdf,Airtime Purchase GTWORLD_QL CT,Airtime Purchase GTWORLDQL CT,utility
04-Jun-2021,'0USAT,04-Jun-2021,"1,000.00",,"38,203.09",Airtime Purchase GTWORLD_QL- 101CT0000000002642380686-2348038673032,SAVINGS ACCOUNT,GT_Bank,./static/raw/MR_IBRAHIM_ASHAFA_STATEMENT.pdf,Airtime Purchase GTWORLD_QL CT,Airtime Purchase GTWORLDQL CT,utility
04-Jun-2021,'0NIPG,04-Jun-2021,"3,000.00",,"35,203.09",NIBSS Instant Payment Outward 000013210604184012000165434057 via GTWORLD  TO YAHAYA ABUBAKAR SADIQ /10.75/REF:GW6819765690000000300021060418  f,SAVINGS ACCOUNT,GT_Bank,./static/raw/MR_IBRAHIM_ASHAFA_STATEMENT.pdf,NIBSS Instant Payment Outward via GTWORLD TO YAHAYA ABUBAKAR SADIQ REF GW f,NIBSS Instant Payment Outward via GTWORLD TO YAHAYA ABUBAKAR SADIQ REF GW,transfert
04-Jun-2021,'0NIPG,04-Jun-2021,10.00,,"35,193.09",COMMISSION 000013210604184012000165434057 NIP TRANSFER COMMISSION FOR 000013210604184012000165434057 via GTWORLD  TO YAHAYA ABUBAKAR SADIQ ReF:GW681976569000000030002106041840,SAVINGS ACCOUNT,GT_Bank,./static/raw/MR_IBRAHIM_ASHAFA_STATEMENT.pdf,COMMISSION NIP TRANSFER COMMISSION FOR via GTWORLD TO YAHAYA ABUBAKAR SADIQ ReF GW,COMMISSION NIP TRANSFER COMMISSION FOR via GTWORLD TO YAHAYA ABUBAKAR SADIQ ReF GW,commission
04-Jun-2021,'0NIPG,04-Jun-2021,.75,,"35,192.34",VALUE ADDED TAX000013210604184012000165434057 VAT ON NIP TRANSFER FOR 000013210604184012000165434057 via GTWORLD  TO YAHAYA ABUBAKAR SADIQ ReF:GW681976569000000030002106041840,SAVINGS ACCOUNT,GT_Bank,./static/raw/MR_IBRAHIM_ASHAFA_STATEMENT.pdf,VALUE ADDED TAX VAT ON NIP TRANSFER FOR via GTWORLD TO YAHAYA ABUBAKAR SADIQ ReF GW,VALUE ADDED TAX VAT ON NIP TRANSFER FOR via GTWORLD TO YAHAYA ABUBAKAR SADIQ ReF GW,tax
05-Jun-2021,'0,04-Jun-2021,100.00,,"35,092.34",STAMP DUTY CHARGE 04062021 STAMP DUTY CHARGE - 04/06/2021,SAVINGS ACCOUNT,GT_Bank,./static/raw/MR_IBRAHIM_ASHAFA_STATEMENT.pdf,STAMP DUTY CHARGE STAMP DUTY CHARGE,STAMP DUTY CHARGE STAMP DUTY CHARGE,bank_charges
05-Jun-2021,'199890000,05-Jun-2021,"8,000.00",,"27,092.34",POS/WEB PURCHASE TRANSACTION  -019989- - 210455-SHEMA PETROLEUM LIMITEDKD LANG,SAVINGS ACCOUNT,GT_Bank,./static/raw/MR_IBRAHIM_ASHAFA_STATEMENT.pdf,POS WEB PURCHASE TRANSACTION SHEMA PETROLEUM LIMITEDKD LANG,POS WEB PURCHASE TRANSACTION SHEMA PETROLEUM LIMITEDKD LANG,utility
06-Jun-2021,'0USAT,06-Jun-2021,900.00,,"26,192.34",Airtime Purchase GTWORLD_QL- 101CT0000000002647174732-2348038673032,SAVINGS ACCOUNT,GT_Bank,./static/raw/MR_IBRAHIM_ASHAFA_STATEMENT.pdf,Airtime Purchase GTWORLD_QL CT,Airtime Purchase GTWORLDQL CT,utility
06-Jun-2021,'3705470000,06-Jun-2021,"6,000.00",,"20,192.34",POS/WEB PURCHASE TRANSACTION  -370547- - 563429-SHEMA PETROLEUM LIMI   KD KDNG,SAVINGS ACCOUNT,GT_Bank,./static/raw/MR_IBRAHIM_ASHAFA_STATEMENT.pdf,POS WEB PURCHASE TRANSACTION SHEMA PETROLEUM LIMI KD KDNG,POS WEB PURCHASE TRANSACTION SHEMA PETROLEUM LIMI KD KDNG,utility
07-Jun-2021,'0NIPG,07-Jun-2021,"4,000.00",,"16,192.34",NIBSS Instant Payment Outward 000013210607071548000168601803 via GTWORLD  TO ABDULLAHI  ASHAFA /10.75/REF:GW6819765690000000400021060707  f,SAVINGS ACCOUNT,GT_Bank,./static/raw/MR_IBRAHIM_ASHAFA_STATEMENT.pdf,NIBSS Instant Payment Outward via GTWORLD TO ABDULLAHI ASHAFA REF GW f,NIBSS Instant Payment Outward via GTWORLD TO ABDULLAHI ASHAFA REF GW,transfert
07-Jun-2021,'0NIPG,07-Jun-2021,10.00,,"16,182.34",COMMISSION 000013210607071548000168601803 NIP TRANSFER COMMISSION FOR 000013210607071548000168601803 via GTWORLD  TO ABDULLAHI  ASHAFA ReF:GW681976569000000040002106070715,SAVINGS ACCOUNT,GT_Bank,./static/raw/MR_IBRAHIM_ASHAFA_STATEMENT.pdf,COMMISSION NIP TRANSFER COMMISSION FOR via GTWORLD TO ABDULLAHI ASHAFA ReF GW,COMMISSION NIP TRANSFER COMMISSION FOR via GTWORLD TO ABDULLAHI ASHAFA ReF GW,commission
07-Jun-2021,'0NIPG,07-Jun-2021,.75,,"16,181.59",VALUE ADDED TAX 000013210607071548000168601803 VAT ON NIP TRANSFER FOR 000013210607071548000168601803 via GTWORLD  TO ABDULLAHI  ASHAFA ReF:GW681976569000000040002106070715,SAVINGS ACCOUNT,GT_Bank,./static/raw/MR_IBRAHIM_ASHAFA_STATEMENT.pdf,VALUE ADDED TAX VAT ON NIP TRANSFER FOR via GTWORLD TO ABDULLAHI ASHAFA ReF GW,VALUE ADDED TAX VAT ON NIP TRANSFER FOR via GTWORLD TO ABDULLAHI ASHAFA ReF GW,tax
07-Jun-2021,'0NIPG,07-Jun-2021,"1,500.00",,"14,681.59",NIBSS Instant Payment Outward 000013210607093405000168787425 via GTWORLD  TO IBRAHIM  FATIMA AMINU /10.75/REF:GW6819765690000000150021060709  f,SAVINGS ACCOUNT,GT_Bank,./static/raw/MR_IBRAHIM_ASHAFA_STATEMENT.pdf,NIBSS Instant Payment Outward via GTWORLD TO IBRAHIM FATIMA AMINU REF GW f,NIBSS Instant Payment Outward via GTWORLD TO IBRAHIM FATIMA AMINU REF GW,transfert
07-Jun-2021,'0NIPG,07-Jun-2021,10.00,,"14,671.59",COMMISSION 000013210607093405000168787425 NIP TRANSFER COMMISSION FOR 000013210607093405000168787425 via GTWORLD  TO IBRAHIM  FATIMA AMINUReF:GW681976569000000015002106070934,SAVINGS ACCOUNT,GT_Bank,./static/raw/MR_IBRAHIM_ASHAFA_STATEMENT.pdf,COMMISSION NIP TRANSFER COMMISSION FOR via GTWORLD TO IBRAHIM FATIMA AMINUReF GW,COMMISSION NIP TRANSFER COMMISSION FOR via GTWORLD TO IBRAHIM FATIMA AMINUReF GW,commission
07-Jun-2021,'0NIPG,07-Jun-2021,.75,,"14,670.84",VALUE ADDED TAX000013210607093405000168787425 VAT ON NIPTRANSFER FOR000013210607093405000168787425 viaGTWORLD  TO IBRAHIM  FATIMA AMINUReF:GW681976569000000015002106070934,SAVINGS ACCOUNT,GT_Bank,./static/raw/MR_IBRAHIM_ASHAFA_STATEMENT.pdf,VALUE ADDED TAX VAT ON NIPTRANSFER FOR viaGTWORLD TO IBRAHIM FATIMA AMINUReF GW,VALUE ADDED TAX VAT ON NIPTRANSFER FOR via GTWORLD TO IBRAHIM FATIMA AMINUReF GW,tax
07-Jun-2021,'0NIPG,07-Jun-2021,"9,000.00",,"5,670.84",NIBSS Instant Payment Outward000013210607094011000168795406 viaGTWORLD  TO IBRAHIM  FATIMA AMINU/26.875/REF:GW6819765690000000900021060709f,SAVINGS ACCOUNT,GT_Bank,./static/raw/MR_IBRAHIM_ASHAFA_STATEMENT.pdf,NIBSS Instant Payment Outward viaGTWORLD TO IBRAHIM FATIMA AMINU REF GW f,NIBSS Instant Payment Outward via GTWORLD TO IBRAHIM FATIMA AMINU REF GW,transfert
07-Jun-2021,'0NIPG,07-Jun-2021,25.00,,"5,645.84",COMMISSION 000013210607094011000168795406NIP TRANSFER COMMISSION FOR000013210607094011000168795406 viaGTWORLD  TO IBRAHIM  FATIMA AMINUReF:GW681976569000000090002106070939,SAVINGS ACCOUNT,GT_Bank,./static/raw/MR_IBRAHIM_ASHAFA_STATEMENT.pdf,COMMISSION NIP TRANSFER COMMISSION FOR viaGTWORLD TO IBRAHIM FATIMA AMINUReF GW,COMMISSION NIP TRANSFER COMMISSION FOR via GTWORLD TO IBRAHIM FATIMA AMINUReF GW,commission
07-Jun-2021,'0NIPG,07-Jun-2021,1.87,,"5,643.97",VALUE ADDED TAX000013210607094011000168795406 VAT ON NIPTRANSFER FOR000013210607094011000168795406 viaGTWORLD  TO IBRAHIM  FATIMA AMINUReF:GW681976569000000090002106070939,SAVINGS ACCOUNT,GT_Bank,./static/raw/MR_IBRAHIM_ASHAFA_STATEMENT.pdf,VALUE ADDED TAX VAT ON NIPTRANSFER FOR viaGTWORLD TO IBRAHIM FATIMA AMINUReF GW,VALUE ADDED TAX VAT ON NIPTRANSFER FOR via GTWORLD TO IBRAHIM FATIMA AMINUReF GW,tax
07-Jun-2021,'0USAT,07-Jun-2021,500.00,,"5,143.97",Airtime Purchase GTWORLD_QL-101CT0000000002648851578-2348038673032,SAVINGS ACCOUNT,GT_Bank,./static/raw/MR_IBRAHIM_ASHAFA_STATEMENT.pdf,Airtime Purchase GTWORLD_QL CT,Airtime Purchase GTWORLDQL CT,utility
07-Jun-2021,'0GAPS,07-Jun-2021,,"18,525.00","23,668.97",TRANSFER BETWEEN CUSTOMERS via GAPSComm on Emmanuel Etalong 1.3m 114508175COMM ON EMMANUEL ETALONG 1.3M fromNETCONSTRUCT NIGERIA LIMITED to ASHAFAIBRAHIM ABDULLAHIREF:0005628626114508175000000,SAVINGS ACCOUNT,GT_Bank,./static/raw/MR_IBRAHIM_ASHAFA_STATEMENT.pdf,TRANSFER BETWEEN CUSTOMERS via GAPSComm on Emmanuel Etalong m COMM ON EMMANUEL ETALONG M fromNETCONSTRUCT NIGERIA LIMITED to ASHAFAIBRAHIM ABDULLAHIREF,TRANSFER BETWEEN CUSTOMERS via GAPSComm on Emmanuel EtalongCOMM ON EMMANUEL ETALONGfrom NETCONSTRUCT NIGERIA LIMITED to ASHAFAIBRAHIM ABDULLAHIREF,transfert
07-Jun-2021,'0GWTR,07-Jun-2021,"3,000.00",,"20,668.97","TRANSFER BETWEEN CUSTOMERS Via GTWorldREF:681976569000000030002106071504  fromASHAFA IBRAHIM ABDULLAHI  to  ABDULLATIF,RUKAYYA",SAVINGS ACCOUNT,GT_Bank,./static/raw/MR_IBRAHIM_ASHAFA_STATEMENT.pdf,TRANSFER BETWEEN CUSTOMERS Via GTWorldREF fromASHAFA IBRAHIM ABDULLAHI to ABDULLATIF RUKAYYA,TRANSFER BETWEEN CUSTOMERS Via GTWorldREF from ASHAFA IBRAHIM ABDULLAHI to ABDULLATIF RUKAYYA,transfert
07-Jun-2021,'0USAT,07-Jun-2021,500.00,,"20,168.97",Airtime Purchase GTWORLD-101CT0000000002649698892-2348038673032,SAVINGS ACCOUNT,GT_Bank,./static/raw/MR_IBRAHIM_ASHAFA_STATEMENT.pdf,Airtime Purchase GTWORLD CT,Airtime Purchase GTWORLD CT,utility
07-Jun-2021,'0NIPT,07-Jun-2021,,"2,005,000.00","2,025,168.97",TRANSFER BETWEEN CUSTOMERS000003210607155309000891578787|web: exchange|S24218089||HOUSE OF IZZI LIMITED REF:000003210607155309000891578787,SAVINGS ACCOUNT,GT_Bank,./static/raw/MR_IBRAHIM_ASHAFA_STATEMENT.pdf,TRANSFER BETWEEN CUSTOMERS web exchange S HOUSE OF IZZI LIMITED REF,TRANSFER BETWEEN CUSTOMERS web exchangeHOUSE OF IZZI LIMITED REF,transfert
07-Jun-2021,'0NIPG,07-Jun-2021,"2,000,000.00",,"25,168.97",NIBSS Instant Payment Outward 000013210607155911000169494588 via GTWORLD Office contributions TO VICTOR IRIKPENATABUCHI EKAWU /53.75/REF:GW6819765690000200000021060715  f,SAVINGS ACCOUNT,GT_Bank,./static/raw/MR_IBRAHIM_ASHAFA_STATEMENT.pdf,NIBSS Instant Payment Outward via GTWORLD Office contributions TO VICTOR IRIKPENATABUCHI EKAWU REF GW f,NIBSS Instant Payment Outward via GTWORLD Office contributions TO VICTOR IRIKPENATABUCHI EKAWU REF GW,transfert
07-Jun-2021,'0NIPG,07-Jun-2021,50.00,,"25,118.97",COMMISSION 000013210607155911000169494588 NIP TRANSFER COMMISSION FOR 000013210607155911000169494588 via GTWORLD Office contributions TO VICTOR IRIKPENATABUCHI EKAWU ReF:GW681976569000020000002106071559,SAVINGS ACCOUNT,GT_Bank,./static/raw/MR_IBRAHIM_ASHAFA_STATEMENT.pdf,COMMISSION NIP TRANSFER COMMISSION FOR via GTWORLD Office contributions TO VICTOR IRIKPENATABUCHI EKAWU ReF GW,COMMISSION NIP TRANSFER COMMISSION FOR via GTWORLD Office contributions TO VICTOR IRIKPENATABUCHI EKAWU ReF GW,commission
07-Jun-2021,'0NIPG,07-Jun-2021,3.75,,"25,115.22",VALUE ADDED TAX 000013210607155911000169494588 VAT ON NIP TRANSFER FOR 000013210607155911000169494588 via GTWORLD Office contributions TO VICTOR IRIKPENATABUCHI EKAWU ReF:GW681976569000020000002106071559,SAVINGS ACCOUNT,GT_Bank,./static/raw/MR_IBRAHIM_ASHAFA_STATEMENT.pdf,VALUE ADDED TAX VAT ON NIP TRANSFER FOR via GTWORLD Office contributions TO VICTOR IRIKPENATABUCHI EKAWU ReF GW,VALUE ADDED TAX VAT ON NIP TRANSFER FOR via GTWORLD Office contributions TO VICTOR IRIKPENATABUCHI EKAWU ReF GW,tax
07-Jun-2021,'0USAT,07-Jun-2021,800.00,,"24,315.22",Airtime Purchase GTWORLD_QL- 101CT0000000002649878676-2347014534625,SAVINGS ACCOUNT,GT_Bank,./static/raw/MR_IBRAHIM_ASHAFA_STATEMENT.pdf,Airtime Purchase GTWORLD_QL CT,Airtime Purchase GTWORLDQL CT,utility
07-Jun-2021,'0NIPG,07-Jun-2021,"8,000.00",,"16,315.22",NIBSS Instant Payment Outward 000013210607164551000169585023 via GTWORLD  TO YUSUF HASSAN /26.875/REF:GW6819765690000000800021060716 f,SAVINGS ACCOUNT,GT_Bank,./static/raw/MR_IBRAHIM_ASHAFA_STATEMENT.pdf,NIBSS Instant Payment Outward via GTWORLD TO YUSUF HASSAN REF GW f,NIBSS Instant Payment Outward via GTWORLD TO YUSUF HASSAN REF GW,transfert
07-Jun-2021,'0NIPG,07-Jun-2021,25.00,,"16,290.22",COMMISSION 000013210607164551000169585023 NIP TRANSFER COMMISSION FOR 000013210607164551000169585023 via GTWORLD  TO YUSUF HASSAN ReF:GW681976569000000080002106071645,SAVINGS ACCOUNT,GT_Bank,./static/raw/MR_IBRAHIM_ASHAFA_STATEMENT.pdf,COMMISSION NIP TRANSFER COMMISSION FOR via GTWORLD TO YUSUF HASSAN ReF GW,COMMISSION NIP TRANSFER COMMISSION FOR via GTWORLD TO YUSUF HASSAN ReF GW,commission
07-Jun-2021,'0NIPG,07-Jun-2021,1.87,,"16,288.35",VALUE ADDED TAX 000013210607164551000169585023 VAT ON NIP TRANSFER FOR 000013210607164551000169585023 via GTWORLD  TO YUSUF HASSAN ReF:GW681976569000000080002106071645,SAVINGS ACCOUNT,GT_Bank,./static/raw/MR_IBRAHIM_ASHAFA_STATEMENT.pdf,VALUE ADDED TAX VAT ON NIP TRANSFER FOR via GTWORLD TO YUSUF HASSAN ReF GW,VALUE ADDED TAX VAT ON NIP TRANSFER FOR via GTWORLD TO YUSUF HASSAN ReF GW,tax
07-Jun-2021,'99990169049999,07-Jun-2021.1,"3,500.00",,"12,788.35",POS/WEB PURCHASE TRANSACTION  -016904- - 660767-RAPHVASELL ENTERPRIS   FC FCNG,SAVINGS ACCOUNT,GT_Bank,./static/raw/MR_IBRAHIM_ASHAFA_STATEMENT.pdf,POS WEB PURCHASE TRANSACTION RAPHVASELL ENTERPRIS FC FCNG,POS WEB PURCHASE TRANSACTION RAPHVASELL ENTERPRIS FC FCNG,utility
08-Jun-2021,'0,07-Jun-2021,50.00,,"12,738.35",STAMP DUTY CHARGE 07062021 STAMP DUTY CHARGE - 07/06/2021,SAVINGS ACCOUNT,GT_Bank,./static/raw/MR_IBRAHIM_ASHAFA_STATEMENT.pdf,STAMP DUTY CHARGE STAMP DUTY CHARGE,STAMP DUTY CHARGE STAMP DUTY CHARGE,bank_charges
08-Jun-2021,'0USAT,08-Jun-2021,600.00,,"12,138.35",Airtime Purchase GTWORLD_QL- 101CT0000000002651358181-2348038673032,SAVINGS ACCOUNT,GT_Bank,./static/raw/MR_IBRAHIM_ASHAFA_STATEMENT.pdf,Airtime Purchase GTWORLD_QL CT,Airtime Purchase GTWORLDQL CT,utility
08-Jun-2021,'0NIPG,08-Jun-2021,"2,000.00",,"10,138.35",NIBSS Instant Payment Outward 000013210608144527000170948975 via GTWORLD  TO UMAR ISAH RABIU /10.75/REF:GW6819765690000000200021060814  f,SAVINGS ACCOUNT,GT_Bank,./static/raw/MR_IBRAHIM_ASHAFA_STATEMENT.pdf,NIBSS Instant Payment Outward via GTWORLD TO UMAR ISAH RABIU REF GW f,NIBSS Instant Payment Outward via GTWORLD TO UMAR ISAH RABIU REF GW,transfert
08-Jun-2021,'0NIPG,08-Jun-2021,10.00,,"10,128.35",COMMISSION 000013210608144527000170948975 NIP TRANSFER COMMISSION FOR 000013210608144527000170948975 via GTWORLD  TO UMAR ISAH RABIU ReF:GW681976569000000020002106081444,SAVINGS ACCOUNT,GT_Bank,./static/raw/MR_IBRAHIM_ASHAFA_STATEMENT.pdf,COMMISSION NIP TRANSFER COMMISSION FOR via GTWORLD TO UMAR ISAH RABIU ReF GW,COMMISSION NIP TRANSFER COMMISSION FOR via GTWORLD TO UMAR ISAH RABIU ReF GW,commission
08-Jun-2021,'0NIPG,08-Jun-2021,.75,,"10,127.60",VALUE ADDED TAX 000013210608144527000170948975 VAT ON NIP TRANSFER FOR 000013210608144527000170948975 via GTWORLD  TO UMAR ISAH RABIU ReF:GW681976569000000020002106081444,SAVINGS ACCOUNT,GT_Bank,./static/raw/MR_IBRAHIM_ASHAFA_STATEMENT.pdf,VALUE ADDED TAX VAT ON NIP TRANSFER FOR via GTWORLD TO UMAR ISAH RABIU ReF GW,VALUE ADDED TAX VAT ON NIP TRANSFER FOR via GTWORLD TO UMAR ISAH RABIU ReF GW,tax
09-Jun-2021,'0USAT,09-Jun-2021,"1,000.00",,"9,127.60",Airtime Purchase GTWORLD_QL- 101CT0000000002653707035-2348038673032,SAVINGS ACCOUNT,GT_Bank,./static/raw/MR_IBRAHIM_ASHAFA_STATEMENT.pdf,Airtime Purchase GTWORLD_QL CT,Airtime Purchase GTWORLDQL CT,utility
09-Jun-2021,'0NIPG,09-Jun-2021,"4,000.00",,"5,127.60",NIBSS Instant Payment Outward 000013210609142049000172467995 via GTWORLD  TO YAKUBU ASHAFA ABDULLAHI /10.75/REF:GW6819765690000000400021060914  f,SAVINGS ACCOUNT,GT_Bank,./static/raw/MR_IBRAHIM_ASHAFA_STATEMENT.pdf,NIBSS Instant Payment Outward via GTWORLD TO YAKUBU ASHAFA ABDULLAHI REF GW f,NIBSS Instant Payment Outward via GTWORLD TO YAKUBU ASHAFA ABDULLAHI REF GW,transfert
09-Jun-2021,'0NIPG,09-Jun-2021,10.00,,"5,117.60",COMMISSION 000013210609142049000172467995 NIP TRANSFER COMMISSION FOR 000013210609142049000172467995 via GTWORLD  TO YAKUBU ASHAFA ABDULLAHI ReF:GW681976569000000040002106091419,SAVINGS ACCOUNT,GT_Bank,./static/raw/MR_IBRAHIM_ASHAFA_STATEMENT.pdf,COMMISSION NIP TRANSFER COMMISSION FOR via GTWORLD TO YAKUBU ASHAFA ABDULLAHI ReF GW,COMMISSION NIP TRANSFER COMMISSION FOR via GTWORLD TO YAKUBU ASHAFA ABDULLAHI ReF GW,commission
09-Jun-2021,'0NIPG,09-Jun-2021,.75,,"5,116.85",VALUE ADDED TAX 000013210609142049000172467995 VAT ON NIP TRANSFER FOR 000013210609142049000172467995 via GTWORLD  TO YAKUBU ASHAFA ABDULLAHI,SAVINGS ACCOUNT,GT_Bank,./static/raw/MR_IBRAHIM_ASHAFA_STATEMENT.pdf,VALUE ADDED TAX VAT ON NIP TRANSFER FOR via GTWORLD TO YAKUBU ASHAFA ABDULLAHI,VALUE ADDED TAX VAT ON NIP TRANSFER FOR via GTWORLD TO YAKUBU ASHAFA ABDULLAHI,tax
99-Apr-9999,,,,,,,SAVINGS ACCOUNT,GT_Bank,./static/raw/MR_IBRAHIM_ASHAFA_STATEMENT.pdf,,nan,others
